Time,End_time,Duration_s,Flow_Lmin,Litros_totales,Dispositivo
1550048311,1550048312,1,5.31,0.177,lavamanos
1550056694,1550056700,6,3.576,0.365,ducha
1550336126,1550336134,8,3.04,0.188,lavamanos
1550338324,1550338586,262,2.46,0.369,lavamanos
1550339333,1550339347,14,2.417142857142857,0.611,lavamanos
1550350532,1550350557,25,3.28,1.435,lavamanos
1550351229,1550351247,18,2.50125,0.763,lavamanos
1550399593,1550399638,45,2.262272727272727,1.739,lavamanos
1550411190,1550411206,16,2.9,0.785,lavamanos
1550416796,1550417183,387,3.5284033613445374,19.137,lavamanos
1550417884,1550417928,44,2.7988235294117647,1.898,lavamanos
1550441095,1550441118,23,3.474,1.416,lavamanos
1550442280,1550442283,3,2.64,0.176,lavamanos
1550474470,1550475904,1434,2.3043478260869565,8.857,lavamanos
1550518075,1550518085,10,2.85,0.522,lavamanos
1550534344,1550534354,10,1.8872727272727272,0.346,lavamanos
1550559494,1550559502,8,2.6533333333333333,0.398,lavamanos
1550560508,1550560543,35,3.667058823529412,2.215,lavamanos
1550561149,1550561522,373,2.9657142857142857,7.718,lavamanos
1550562166,1550562682,516,2.7848275862068967,3.182,lavamanos
1550618780,1550619285,505,2.0966666666666667,1.34,lavamanos
1550655750,1550657001,1251,3.168085106382979,7.948,lavamanos
1550679243,1550679253,10,2.16,0.405,lavamanos
1550679870,1550679879,9,2.633333333333333,0.397,lavamanos
1550687118,1550687671,553,2.655111111111111,6.763,lavamanos
1550692954,1550692987,33,3.222,1.467,lavamanos
1550694259,1550694297,38,5.623333333333333,3.578,lavamanos
1550695194,1550695912,718,2.8493023255813954,3.999,lavamanos
1550698906,1550698911,5,2.56,0.256,lavamanos
1550701368,1550701632,264,3.415714285714286,2.53,lavamanos
1550706891,1550706904,13,2.353846153846154,0.514,lavamanos
1550708174,1550708192,18,3.3,1.064,lavamanos
1550709038,1550709042,4,2.205,0.198,lavamanos
1550711856,1550711876,20,3.156,1.162,lavamanos
1550735728,1550736074,346,2.4370786516853933,3.833,lavamanos
1550736787,1550737052,265,3.186,1.723,lavamanos
1550778313,1550778326,13,2.8846153846153846,0.681,lavamanos
1550786533,1550786549,16,2.85,0.814,lavamanos
1550801511,1550801870,359,0.8663157894736842,0.873,lavamanos
1550803987,1550804027,40,2.3676923076923075,1.621,lavamanos
1550823272,1550823297,25,3.47,1.522,lavamanos
1550831248,1550831263,15,2.9879999999999995,0.803,lavamanos
1550843805,1550843826,21,2.0171428571428573,0.742,lavamanos
1550847750,1550847759,9,4.218,0.703,lavamanos
1550850687,1550850721,34,3.3163636363636364,1.942,lavamanos
1550853568,1550853747,179,3.2038709677419352,10.004,lavamanos
1550854911,1550855220,309,2.0949152542372884,2.212,lavamanos
1550855954,1550856229,275,0.72,0.06,lavamanos
1550870830,1550870841,11,1.7,0.34,lavamanos
1550908414,1550908429,15,1.652,0.444,lavamanos
1550922958,1550922969,11,1.38,0.276,ducha
1550923809,1550923829,20,0.7949999999999999,0.278,lavamanos
1550929421,1550930339,918,2.6533333333333333,8.991,lavamanos
1550930969,1550930974,5,0.94,0.08,lavamanos
1550943029,1550943507,478,0.12,0.958,ducha
1550944293,1550944306,13,0.996923076923077,0.234,lavamanos
1550951813,1550951836,23,3.2945454545454544,1.331,lavamanos
1550996598,1550998005,1407,2.061019108280255,5.755,lavamanos
1551042311,1551042331,20,3.6252631578947367,1.248,lavamanos
1551044146,1551044152,6,3.12,0.364,lavamanos
1551078274,1551078280,6,3.1,0.379,lavamanos
1551079349,1551079371,22,1.778181818181818,0.685,lavamanos
1551080092,1551081659,1567,2.6970652173913043,8.97,lavamanos
1551095846,1551095846,1,0.78,0.013,lavamanos
1551112805,1551113165,360,0.72,4.319999999999999,inodoro
1551124757,1551124779,22,2.1514285714285712,0.831,lavamanos
1551132494,1551132559,65,2.764615384615385,5.355,lavamanos
1551135919,1551135938,19,2.172631578947368,0.726,lavamanos
1551136592,1551136596,4,1.2,0.1,lavamanos
1551136662,1551137022,360,0.72,4.319999999999999,inodoro
1551163222,1551163226,4,1.392,0.116,lavamanos
1551163319,1551163679,360,0.72,4.319999999999999,inodoro
1551172958,1551172971,13,2.147142857142857,0.501,lavamanos
1551173803,1551173805,2,0.18,0.008,lavamanos
1551176488,1551176968,480,2.88,1.299,lavamanos
1551177569,1551177584,15,3.642857142857143,0.88,lavamanos
1551180802,1551180805,3,1.02,0.068,lavamanos
1551181357,1551181717,360,0.72,4.319999999999999,inodoro
1551184544,1551184638,94,1.44375,0.726,lavamanos
1551185644,1551185710,66,2.357142857142857,1.221,lavamanos
1551186979,1551187148,169,2.625714285714285,1.266,lavamanos
1551191362,1551191388,26,3.069230769230769,1.386,lavamanos
1551192560,1551193252,692,4.331328671328671,21.549,lavamanos
1551201563,1551201923,360,0.72,4.319999999999999,inodoro
1551215602,1551215962,360,0.72,4.319999999999999,inodoro
1551249722,1551250948,1226,3.931221719457013,16.49,ducha
1551250742,1551252164,1422,2.937165354330708,6.565,lavamanos
1551252782,1551252902,120,1.33,0.363,lavamanos
1551257560,1551257920,360,0.72,4.319999999999999,inodoro
1551286587,1551286601,14,3.69,0.933,lavamanos
1551287553,1551287580,27,2.285,1.051,lavamanos
1551289362,1551289722,360,0.72,4.319999999999999,inodoro
1551305542,1551305552,10,1.464,0.253,lavamanos
1551335390,1551337187,1797,0.2599999999999999,0.735,ducha
1551335545,1551335905,360,0.72,4.319999999999999,inodoro
1551335658,1551337755,2097,2.38,11.207,lavamanos
1551371339,1551371699,360,0.72,4.319999999999999,inodoro
1551379582,1551379594,12,5.575,1.119,lavamanos
1551380790,1551380910,120,2.9505882352941177,2.879,lavamanos
1551384226,1551384405,179,4.074,1.516,lavamanos
1551393050,1551393226,176,3.7175,1.592,lavamanos
1551394907,1551394987,80,2.3125,1.299,lavamanos
1551422209,1551422569,360,0.72,4.319999999999999,inodoro
1551422701,1551423061,360,0.72,4.319999999999999,inodoro
1551426306,1551426666,360,0.72,4.319999999999999,inodoro
1551427376,1551427448,72,1.2342857142857144,2.064,lavamanos
1551430351,1551430354,3,0.96,0.064,lavamanos
1551435407,1551438717,3310,4.442068965517241,10.176,lavaplatos
1551439207,1551439567,360,0.72,4.319999999999999,inodoro
1551440826,1551441839,1013,3.36,1.306,lavaplatos
1551444362,1551446336,1974,2.0727272727272728,12.383,lavamanos
1551465957,1551470314,4357,1.8013333333333332,27.371,lavaplatos
1551475985,1551476162,177,1.1365714285714286,2.313,lavaplatos
1551479205,1551479230,25,2.0136000000000003,0.875,lavamanos
1551479301,1551479661,360,0.72,4.319999999999999,inodoro
1551510248,1551511717,1469,3.465445544554455,14.958,lavaplatos
1551515412,1551516736,1324,3.1910769230769227,3.71,lavaplatos
1551519877,1551520500,623,2.58,2.076,lavamanos
1551521944,1551521962,18,2.02,0.633,lavamanos
1551522524,1551522884,360,0.72,4.319999999999999,inodoro
1551525612,1551525633,21,1.0857142857142856,0.398,lavamanos
1551525990,1551528526,2536,2.243157894736842,16.09,lavaplatos
1551535962,1551538776,2814,3.47140758873929,51.806,ducha
1551537301,1551539714,2413,1.6990384615384615,3.407,lavamanos
1551539412,1551539772,360,0.72,4.319999999999999,inodoro
1551549181,1551549196,15,2.476,0.623,lavamanos
1551550748,1551550758,10,0.3675,0.055,lavaplatos
1551560140,1551560500,360,0.72,4.319999999999999,inodoro
1551583316,1551583334,18,2.91,0.933,lavamanos
1551602074,1551602079,5,1.68,0.168,lavaplatos
1551604782,1551606482,1700,2.0538028169014084,9.532,lavamanos
1551605098,1551605309,211,1.14,5.708,ducha
1551606539,1551608151,1612,1.5490909090909089,0.646,lavaplatos
1551643554,1551643574,20,1.951578947368421,0.692,lavamanos
1551643854,1551644992,1138,1.813684210526316,18.553,lavaplatos
1551645534,1551645541,7,1.1325,0.151,lavamanos
1551648225,1551648266,41,1.4069999999999998,0.989,lavamanos
1551678811,1551679171,360,0.72,4.319999999999999,inodoro
1551682964,1551683130,166,2.605714285714286,1.546,lavaplatos
1551683833,1551684486,653,2.6512299465240643,10.374,lavamanos
1551685278,1551685296,18,1.1366666666666665,0.361,lavamanos
1551693380,1551693740,360,0.72,4.319999999999999,inodoro
1551736044,1551736059,15,2.804,0.75,lavamanos
1551736130,1551736490,360,0.72,4.319999999999999,inodoro
1551768518,1551768878,360,0.72,4.319999999999999,inodoro
1551768995,1551769005,10,1.963636363636364,0.36,lavaplatos
1551771397,1551771419,22,3.212727272727273,1.241,lavaplatos
1551775586,1551777055,1469,2.4266666666666663,5.073,lavaplatos
1551781790,1551782354,564,2.605531914893617,10.177,lavaplatos
1551782678,1551782700,22,0.8,0.308,lavamanos
1551787448,1551788103,655,1.3957142857142857,8.383,lavaplatos
1551787779,1551787781,2,1.18,0.059,lavamanos
1551790628,1551790988,360,0.72,4.319999999999999,inodoro
1551795751,1551795771,20,2.064,0.726,lavamanos
1551796439,1551796734,295,1.5565384615384616,1.94,lavamanos
1551796439,1551796524,85,0.24,0.512,ducha
1551797792,1551797875,83,1.8372151898734177,2.567,lavamanos
1551798492,1551799336,844,1.0654545454545454,1.613,lavamanos
1551799422,1551799782,360,0.72,4.319999999999999,inodoro
1551866556,1551866916,360,0.72,4.319999999999999,inodoro
1551872374,1551872734,360,0.72,4.319999999999999,inodoro
1551888517,1551897786,9269,0.9675,4.585,ducha
1551888518,1551888878,360,0.72,4.319999999999999,inodoro
1551888593,1551888610,17,1.236,0.231,lavaplatos
1551889503,1551889853,350,0.72,0.052,lavamanos
1551899717,1551899735,18,2.59,0.828,lavamanos
1551900095,1551900390,295,1.9733333333333327,8.481,lavaplatos
1551900988,1551901037,49,2.2429787234042555,1.873,lavamanos
1551903968,1551904597,629,5.803654822335026,60.577,ducha
1551904039,1551904160,121,2.156470588235294,1.608,lavamanos
1551907869,1551908229,360,0.72,4.319999999999999,inodoro
1551932713,1551933472,759,1.573972602739726,4.057,lavamanos
1551933874,1551934234,360,0.72,4.319999999999999,inodoro
1552235085,1552236674,1589,1.7704477611940297,5.535,lavaplatos
1552236924,1552236925,1,1.7999999999999998,0.06,lavamanos
1552236979,1552240309,3330,3.626885245901639,35.184,ducha
1552239589,1552239605,16,0.79875,0.226,lavamanos
1552241000,1552243386,2386,1.801090909090909,6.286,lavamanos
1552242106,1552242466,360,0.72,4.319999999999999,inodoro
1552243624,1552243659,35,3.54,2.138,lavaplatos
1552249905,1552249919,14,1.429090909090909,0.27,lavaplatos
1552254243,1552254603,360,0.72,4.319999999999999,inodoro
1552286203,1552286563,360,0.72,4.319999999999999,inodoro
1552286552,1552286912,360,0.72,4.319999999999999,inodoro
1552286805,1552286823,18,0.75,0.238,lavamanos
1552287028,1552287641,613,2.4734328358208955,2.941,lavaplatos
1552288426,1552288994,568,0.8799999999999999,0.426,lavamanos
1552299181,1552299195,14,2.04,0.494,lavamanos
1552299930,1552299954,24,2.4327272727272726,1.073,lavamanos
1552304330,1552304338,8,1.7,0.255,lavamanos
1552305105,1552305125,20,2.232,0.784,lavamanos
1552305192,1552308346,3154,2.30203125,15.309,lavaplatos
1552306717,1552306734,17,0.7941176470588235,0.238,lavamanos
1552313962,1552314322,360,0.72,4.319999999999999,inodoro
1552319622,1552319637,15,1.984,0.532,lavamanos
1552321643,1552322539,896,2.473150684931507,7.832,lavamanos
1552404033,1552404393,360,0.72,4.319999999999999,inodoro
1552404860,1552405220,360,0.72,4.319999999999999,inodoro
1552419860,1552419877,17,1.972941176470588,0.595,lavamanos
1552421271,1552422476,1205,1.6688888888888886,9.624,lavaplatos
1552422133,1552422155,22,1.9527272727272729,0.752,lavamanos
1552459254,1552459614,360,0.72,4.319999999999999,inodoro
1552460646,1552461146,500,1.6707692307692308,3.196,lavaplatos
1552461437,1552461797,360,0.72,4.319999999999999,inodoro
1552461540,1552461722,182,2.179148936170213,2.355,lavamanos
1552462481,1552463076,595,1.995,1.394,lavamanos
1552515276,1552515280,4,0.585,0.041,lavaplatos
1552515937,1552517054,1117,3.3046336633663365,60.615,ducha
1552516394,1552516889,495,3.208571428571428,3.492,lavamanos
1552517794,1552517806,12,1.536923076923077,0.333,lavamanos
1552518530,1552518890,360,0.72,4.319999999999999,inodoro
1552545965,1552546063,98,2.52,0.7,lavaplatos
1552546775,1552548419,1644,1.5760714285714286,4.684,lavamanos
1552583010,1552583028,18,1.2133333333333332,0.384,lavamanos
1552583872,1552584263,391,1.5313043478260868,4.229,lavaplatos
1552584286,1552584302,16,0.97875,0.276,lavamanos
1552584321,1552584681,360,0.72,4.319999999999999,inodoro
1552602146,1552602506,360,0.72,4.319999999999999,inodoro
1552621716,1552621719,3,0.99,0.066,lavamanos
1552634065,1552634425,360,0.72,4.319999999999999,inodoro
1552634692,1552635360,668,2.0906666666666665,5.141,lavaplatos
1552635495,1552635513,18,1.1233333333333333,0.357,lavamanos
1552635694,1552636054,360,0.72,4.319999999999999,inodoro
1552640222,1552640582,360,0.72,4.319999999999999,inodoro
1552648344,1552648347,3,0.86,0.067,lavaplatos
1552651013,1552652024,1011,1.6983333333333337,8.403,lavaplatos
1552651351,1552651365,14,1.2257142857142855,0.308,lavamanos
1552657975,1552659465,1490,1.2879245283018868,3.647,lavamanos
1552659584,1552659944,360,0.72,4.319999999999999,inodoro
1552678776,1552678796,20,2.646,0.931,lavamanos
1552679695,1552679698,3,1.065,0.071,lavaplatos
1552684808,1552685096,288,3.0376470588235294,7.338,lavaplatos
1552691771,1552692476,705,2.6021739130434782,4.034,lavamanos
1552692090,1552692450,360,0.72,4.319999999999999,inodoro
1552719088,1552719448,360,0.72,4.319999999999999,inodoro
1552719412,1552719461,49,0.708,0.149,lavaplatos
1552724866,1552724893,27,1.111764705882353,0.373,lavaplatos
1552725074,1552725434,360,0.72,4.319999999999999,inodoro
1552728042,1552729279,1237,1.742727272727273,10.028,lavaplatos
1552730333,1552730693,360,0.72,4.319999999999999,inodoro
1552730411,1552730565,154,3.54,1.513,lavamanos
1552733219,1552733378,159,4.582105263157894,3.784,lavamanos
1552734270,1552735091,821,3.381923076923077,3.134,lavamanos
1552736959,1552736964,5,6.3,0.63,lavaplatos
1552737412,1552738382,970,1.940751879699248,7.643,lavamanos
1552738848,1552738850,2,1.18,0.059,lavaplatos
1552752662,1552754463,1801,2.752027972027972,27.627,lavaplatos
1552754519,1552754879,360,0.72,4.319999999999999,inodoro
1552757357,1552757902,545,2.2725,7.145,lavaplatos
1552757809,1552757924,115,2.29,1.252,lavamanos
1552761530,1552761530,1,0.36,0.006,lavamanos
1552780980,1552781011,31,0.8676923076923077,0.469,lavamanos
1552807032,1552807974,942,2.2729787234042558,25.635,lavaplatos
1552809315,1552809590,275,2.190782608695652,6.443,lavamanos
1552810190,1552810550,360,0.72,4.319999999999999,inodoro
1552810808,1552811508,700,1.835217391304348,1.527,lavamanos
1552811949,1552812266,317,0.5549999999999999,0.665,lavaplatos
1552951941,1552952115,174,2.907857142857143,7.662,lavaplatos
1552952188,1552952696,508,1.0102702702702704,0.696,lavamanos
1552952664,1552953024,360,0.72,4.319999999999999,inodoro
1552953501,1552953861,360,0.72,4.319999999999999,inodoro
1552977169,1552977947,778,1.3023529411764707,18.76,lavaplatos
1552978689,1552978866,177,4.638072289156626,13.651,ducha
1552978856,1552980721,1865,2.0016923076923074,7.581,lavamanos
1553017013,1553017029,16,1.14375,0.307,lavamanos
1553017785,1553017935,150,1.3563636363636362,2.887,lavamanos
1553026410,1553026424,14,1.0457142857142856,0.264,lavamanos
1553026560,1553026869,309,1.166938775510204,2.285,lavaplatos
1553030250,1553030610,360,0.72,4.319999999999999,inodoro
1553031424,1553031784,360,0.72,4.319999999999999,inodoro
1553038802,1553038920,118,1.5233333333333332,0.886,lavamanos
1553066023,1553066383,360,0.72,4.319999999999999,inodoro
1553066527,1553066558,31,3.29,1.763,lavaplatos
1553068085,1553068445,360,0.72,4.319999999999999,inodoro
1553069944,1553069945,1,2.07,0.069,lavaplatos
1553072459,1553072469,10,3.212727272727273,0.589,lavaplatos
1553076012,1553076715,703,2.425,4.616,lavaplatos
1553080513,1553082812,2299,2.167860262008733,18.886,lavaplatos
1553081004,1553081020,16,0.97875,0.279,lavamanos
1553082902,1553083262,360,0.72,4.319999999999999,inodoro
1553085497,1553085999,502,2.772,0.231,lavamanos
1553089855,1553090401,546,1.2811764705882351,6.452,lavaplatos
1553093080,1553093224,144,2.13,2.822,lavaplatos
1553100915,1553101886,971,1.73682119205298,5.613,lavamanos
1553102506,1553103029,523,1.184,1.585,lavamanos
1553103078,1553103438,360,0.72,4.319999999999999,inodoro
1553118814,1553119375,561,4.959529411764706,46.662,ducha
1553118826,1553118937,111,1.9733333333333327,3.665,lavamanos
1553119793,1553120347,554,1.54125,1.664,lavamanos
1553123921,1553124281,360,0.72,4.319999999999999,inodoro
1553149089,1553149094,5,0.6399999999999999,0.064,lavamanos
1553149596,1553149727,131,3.684545454545454,2.888,lavaplatos
1553150046,1553151709,1663,1.4637410071942445,3.701,lavamanos
1553151294,1553151654,360,0.72,4.319999999999999,inodoro
1553199752,1553200261,509,2.259230769230769,1.748,lavaplatos
1553199805,1553199823,18,1.609090909090909,0.521,lavamanos
1553204972,1553205334,362,3.285957446808511,11.501,lavamanos
1553238160,1553238487,327,3.964390243902439,8.311,lavaplatos
1553239187,1553239722,535,1.225233644859813,2.568,lavamanos
1553239859,1553240219,360,0.72,4.319999999999999,inodoro
1553240954,1553240999,45,1.0619999999999998,0.483,lavamanos
1553241578,1553241583,5,2.41,0.241,lavaplatos
1553243704,1553243706,2,1.72,0.086,lavaplatos
1553245485,1553245508,23,1.8628571428571428,0.728,lavamanos
1553248454,1553248504,50,3.738461538461538,1.076,lavamanos
1553249013,1553249021,8,1.15,0.121,lavaplatos
1553249761,1553250121,360,0.72,4.319999999999999,inodoro
1553251502,1553251506,4,2.592,0.216,lavaplatos
1553253315,1553253927,612,2.315625,1.495,lavamanos
1553253327,1553254835,1508,1.0545454545454545,1.374,lavaplatos
1553256813,1553259123,2310,2.2078125,4.115,lavaplatos
1553261021,1553261040,19,0.5210526315789473,0.174,lavamanos
1553264098,1553264569,471,1.164,0.842,lavamanos
1553266446,1553266466,20,0.9315789473684212,0.331,lavamanos
1553268082,1553268269,187,3.3163636363636364,4.641,lavaplatos
1553270909,1553271123,214,1.99,5.623,lavaplatos
1553276625,1553277705,1080,1.8556097560975608,1.804,lavaplatos
1553279976,1553280336,360,0.72,4.319999999999999,inodoro
1553281827,1553281876,49,1.26,0.525,lavamanos
1553292326,1553292360,34,0.8999999999999999,0.328,lavamanos
1553323306,1553325835,2529,1.152,20.624,lavaplatos
1553323597,1553323957,360,0.72,4.319999999999999,inodoro
1553328041,1553329309,1268,2.401935483870968,19.467,lavaplatos
1553333035,1553333041,6,0.7628571428571428,0.089,lavaplatos
1553337548,1553337908,360,0.72,4.319999999999999,inodoro
1553341709,1553342000,291,1.3378124999999998,6.24,lavaplatos
1553344549,1553345671,1122,3.415151515151515,14.231,lavaplatos
1553345576,1553345602,26,2.6533333333333333,0.434,lavamanos
1553354668,1553355437,769,1.4986466165413534,3.692,lavamanos
1553356123,1553356562,439,2.2060975609756097,7.481,lavamanos
1553357640,1553357659,19,1.1314285714285717,0.204,lavamanos
1553371728,1553371816,88,0.9866666666666666,0.918,lavamanos
1553371823,1553372949,1126,1.7482758620689651,5.541,lavaplatos
1553373100,1553373128,28,1.116923076923077,0.544,lavamanos
1553373842,1553373845,3,0.8999999999999999,0.06,lavamanos
1553390587,1553390606,19,1.74,0.58,lavamanos
1553410479,1553410839,360,0.72,4.319999999999999,inodoro
1553411081,1553411137,56,1.781111111111111,1.687,lavaplatos
1553412218,1553412254,36,1.368,0.282,lavamanos
1553419434,1553420418,984,1.7768421052631578,7.745,lavamanos
1553420717,1553429384,8667,2.7265841584158417,61.823,lavaplatos
1553426182,1553426200,18,1.8333333333333333,0.588,lavamanos
1553431378,1553431464,86,1.6684615384615384,1.021,lavamanos
1553433336,1553433671,335,0.6599999999999999,6.702,lavaplatos
1553433442,1553433499,57,1.272,0.424,lavamanos
1553433665,1553434025,360,0.72,4.319999999999999,inodoro
1553434476,1553435822,1346,3.1875,17.748,lavamanos
1553435525,1553435885,360,0.72,4.319999999999999,inodoro
1553437811,1553440624,2813,2.110961538461538,17.162,lavaplatos
1553443072,1553443767,695,1.6291304347826083,11.619,lavaplatos
1553446168,1553450908,4740,1.836044776119403,40.762,lavaplatos
1553448602,1553448962,360,0.72,4.319999999999999,inodoro
1553451459,1553451819,360,0.72,4.319999999999999,inodoro
1553457971,1553458331,360,0.72,4.319999999999999,inodoro
1553457972,1553458024,52,0.645,0.176,lavamanos
1553461352,1553461712,360,0.72,4.319999999999999,inodoro
1553461574,1553462454,880,3.065334957369062,44.759,ducha
1553461911,1553462831,920,3.07231884057971,23.755,lavamanos
1553497077,1553498487,1410,2.17125,10.98,lavaplatos
1553498309,1553498590,281,1.885321100917431,4.707,lavamanos
1553499227,1553500302,1075,0.962,2.762,lavamanos
1553500359,1553500719,360,0.72,4.319999999999999,inodoro
1553543611,1553543649,38,1.4652631578947368,0.562,lavamanos
1553544724,1553544747,23,1.3609090909090908,0.55,lavaplatos
1553545143,1553545503,360,0.72,4.319999999999999,inodoro
1553554095,1553554455,360,0.72,4.319999999999999,inodoro
1553581384,1553581477,93,1.2733333333333332,1.721,lavamanos
1553581798,1553582521,723,1.4674999999999998,4.262,lavaplatos
1553582921,1553583281,360,0.72,4.319999999999999,inodoro
1553583397,1553583411,14,2.232,0.558,lavamanos
1553584351,1553584447,96,0.8785714285714286,0.679,lavaplatos
1553587635,1553587677,42,1.9114285714285717,0.65,lavamanos
1553590439,1553590516,77,2.598648648648649,3.382,lavamanos
1553590584,1553590944,360,0.72,4.319999999999999,inodoro
1553592032,1553592392,360,0.72,4.319999999999999,inodoro
1553598651,1553598669,18,1.14,0.362,lavamanos
1553598696,1553600306,1610,2.4033707865168537,22.087,lavaplatos
1553599881,1553601078,1197,1.824198895027624,8.008,lavamanos
1553614189,1553614207,18,1.4966666666666666,0.478,lavamanos
1553615242,1553617954,2712,3.0117391304347825,25.286,lavaplatos
1553627095,1553627216,121,2.659310344827586,4.208,lavaplatos
1553627450,1553627756,306,2.1580645161290324,2.474,lavamanos
1553627613,1553627973,360,0.72,4.319999999999999,inodoro
1553644119,1553644135,16,0.82875,0.236,lavamanos
1553669248,1553669624,376,2.828,1.487,lavaplatos
1553669844,1553671506,1662,1.2760975609756098,7.811,lavamanos
1553677297,1553677657,360,0.72,4.319999999999999,inodoro
1553723204,1553723687,483,1.584,0.132,lavamanos
1553723204,1553724095,891,5.545436105476673,82.584,ducha
1553723490,1553723850,360,0.72,4.319999999999999,inodoro
1553724814,1553724821,7,1.14,0.164,lavamanos
1553754708,1553755068,360,0.72,4.319999999999999,inodoro
1553756212,1553756300,88,2.5254545454545454,2.135,lavamanos
1553756300,1553756660,360,0.72,4.319999999999999,inodoro
1553756483,1553756493,10,0.7919999999999999,0.078,lavaplatos
1553759901,1553759909,8,1.14,0.181,lavamanos
1553761552,1553764764,3212,2.737714285714285,48.64,lavaplatos
1553764211,1553764211,1,0.6599999999999999,0.011,lavamanos
1553769477,1553769518,41,1.831578947368421,0.704,lavamanos
1553773127,1553773158,31,0.9171428571428571,0.207,lavaplatos
1553773921,1553773944,23,3.0054545454545454,1.177,lavamanos
1553777234,1553777247,13,2.644615384615385,0.62,lavaplatos
1553781135,1553781174,39,1.2178378378378378,0.795,lavamanos
1553786777,1553786792,15,1.96,0.429,lavaplatos
1553794702,1553795271,569,2.0834042553191487,5.879,lavamanos
1553808669,1553808674,5,1.34,0.073,lavaplatos
1553808716,1553808730,14,1.08,0.258,lavamanos
1553809485,1553809845,360,0.72,4.319999999999999,inodoro
1553811934,1553812149,215,1.599622641509434,4.143,lavaplatos
1553841889,1553843622,1733,1.3311111111111111,0.632,lavaplatos
1553842232,1553842931,699,1.503,4.044,lavamanos
1553888111,1553888127,16,0.992,0.275,lavamanos
1553893307,1553893319,12,0.7,0.084,lavaplatos
1553898912,1553898920,8,1.3885714285714286,0.166,lavaplatos
1553899157,1553899517,360,0.72,4.319999999999999,inodoro
1553913494,1553913854,360,0.72,4.319999999999999,inodoro
1553927390,1553927407,17,1.248,0.34,lavaplatos
1553938304,1553940231,1927,1.2705882352941176,0.476,lavaplatos
1553942080,1553942090,10,1.95,0.365,lavaplatos
1553944059,1553944465,406,0.12,0.814,lavaplatos
1553945769,1553946331,562,1.680923076923077,5.732,lavamanos
1553946101,1553946461,360,0.72,4.319999999999999,inodoro
1554043540,1554044299,759,0.7975,11.812,lavaplatos
1554044023,1554045471,1448,1.2336690647482014,4.998,lavamanos
1554046285,1554046294,9,0.98,0.165,lavamanos
1554072087,1554072103,16,2.20125,0.629,lavamanos
1554099001,1554099983,982,1.6736842105263157,0.53,lavaplatos
1554101226,1554101586,360,0.72,4.319999999999999,inodoro
1554111053,1554112666,1613,1.9365714285714288,7.369,lavaplatos
1554114561,1554115046,485,2.885827814569536,23.228,ducha
1554114611,1554115023,412,4.459279279279279,27.687,lavamanos
1554115631,1554116312,681,2.047692307692308,1.617,lavamanos
1554116810,1554117170,360,0.72,4.319999999999999,inodoro
1554134595,1554134622,27,1.4974999999999998,0.664,lavamanos
1554155549,1554156773,1224,1.886315789473684,3.149,lavaplatos
1554157362,1554157383,21,0.894,0.328,lavamanos
1554183760,1554183765,5,2.13,0.213,lavamanos
1554183905,1554184652,747,1.0035,2.559,lavaplatos
1554184786,1554185146,360,0.72,4.319999999999999,inodoro
1554185593,1554186081,488,1.6396153846153845,3.663,lavamanos
1554186759,1554186775,16,2.4975,0.396,lavaplatos
1554187029,1554187350,321,1.1178947368421053,2.874,lavamanos
1554188017,1554188832,815,0.8290909090909091,3.058,lavamanos
1554188868,1554189228,360,0.72,4.319999999999999,inodoro
1554198548,1554198908,360,0.0,0.0,inodoro
1554198586,1554198946,360,0.0,0.0,inodoro
1554198805,1554199165,360,0.0,0.0,inodoro
1554198817,1554199177,360,0.0,0.0,inodoro
1554232933,1554233534,601,2.2928571428571427,8.377,lavaplatos
1554242098,1554242458,360,0.72,4.319999999999999,inodoro
1554285793,1554286153,360,0.72,4.319999999999999,inodoro
1554325174,1554325178,4,2.04,0.17,lavaplatos
1554326080,1554327056,976,3.620601769911504,36.878,ducha
1554326476,1554327034,558,5.002941176470587,7.83,lavamanos
1554353956,1554354316,360,0.72,4.319999999999999,inodoro
1554354011,1554354350,339,1.7745454545454544,9.791,lavaplatos
1554355077,1554356162,1085,1.6232142857142855,6.006,lavamanos
1554356842,1554357202,360,0.72,4.319999999999999,inodoro
1554397414,1554397428,14,1.1228571428571428,0.286,lavamanos
1554398016,1554398376,360,0.72,4.319999999999999,inodoro
1554398080,1554398271,191,1.7938235294117648,4.038,lavamanos
1554417035,1554417661,626,1.0139999999999998,0.545,lavamanos
1554452645,1554452831,186,0.72,4.094,ducha
1554452847,1554454345,1498,1.46,6.304,lavamanos
1554454646,1554455006,360,0.72,4.319999999999999,inodoro
1554470306,1554470427,121,1.63,3.619,lavamanos
1554477737,1554477778,41,1.5466666666666666,0.541,lavamanos
1554482562,1554482601,39,3.7097142857142855,2.503,lavamanos
1554485870,1554486328,458,5.231944444444444,39.905,ducha
1554485974,1554486014,40,3.0,1.96,lavamanos
1554487677,1554487678,1,0.6599999999999999,0.022,lavamanos
1554489022,1554489108,86,0.9966666666666666,1.065,lavamanos
1554490031,1554490391,360,0.72,4.319999999999999,inodoro
1554510644,1554510972,328,0.7152,0.326,lavamanos
1554536037,1554536397,360,0.72,4.319999999999999,inodoro
1554537997,1554539273,1276,1.875,9.614,lavamanos
1554540069,1554540429,360,0.72,4.319999999999999,inodoro
1554552091,1554552451,360,0.72,4.319999999999999,inodoro
1554561496,1554561856,360,0.72,4.319999999999999,inodoro
1554563564,1554563657,93,1.5419999999999998,1.052,lavamanos
1554565323,1554565337,14,2.314285714285714,0.582,lavamanos
1554565953,1554566012,59,0.12,0.12,ducha
1554593323,1554593343,20,1.5705882352941176,0.484,lavamanos
1554604304,1554605069,765,0.9982978723404256,0.92,lavamanos
1554619425,1554619785,360,0.72,4.319999999999999,inodoro
1554625316,1554626124,808,2.939503448275862,39.458,ducha
1554625435,1554627289,1854,1.7331818181818182,14.358,lavamanos
1554625904,1554625924,20,1.1,0.091,lavaplatos
1554809311,1554809671,360,0.72,4.319999999999999,inodoro
1554809398,1554809410,12,1.7599999999999998,0.39,lavamanos
1554809452,1554811866,2414,2.1685714285714286,24.749,lavaplatos
1554813025,1554813385,360,0.72,4.319999999999999,inodoro
1554813881,1554813891,10,2.110909090909091,0.387,lavamanos
1554820620,1554820781,161,1.2106451612903224,1.74,lavamanos
1554821564,1554821569,5,1.83,0.183,lavaplatos
1554835073,1554835790,717,1.6889999999999998,6.992,lavaplatos
1554836724,1554837083,359,6.175548961424332,36.843,ducha
1554837318,1554837598,280,1.395,0.616,lavamanos
1554837469,1554837829,360,0.72,4.319999999999999,inodoro
1554838850,1554839351,501,1.4684210526315788,0.514,lavaplatos
1554841112,1554841186,74,1.5054545454545454,0.564,lavamanos
1554847279,1554847487,208,2.34,4.985,lavaplatos
1554847299,1554847299,1,0.6599999999999999,0.011,lavamanos
1554850686,1554850807,121,2.185,0.877,lavamanos
1554875951,1554876207,256,1.7733333333333334,11.787,lavaplatos
1554876223,1554876295,72,1.1142857142857143,0.526,lavamanos
1554876950,1554877470,520,1.7093023255813953,6.65,lavamanos
1554878053,1554878413,360,0.72,4.319999999999999,inodoro
1554878613,1554879074,461,1.5035294117647058,1.31,lavamanos
1554879864,1554879868,4,0.825,0.057,lavaplatos
1554931019,1554931532,513,0.9696,0.728,lavamanos
1554964133,1554964138,5,2.74,0.274,lavaplatos
1554964652,1554965012,360,0.72,4.319999999999999,inodoro
1554964778,1554966505,1727,1.1945454545454546,4.976,lavamanos
1555014276,1555014278,2,1.2799999999999998,0.064,lavaplatos
1555014317,1555014336,19,0.992,0.328,lavamanos
1555014763,1555015123,360,0.72,4.319999999999999,inodoro
1555029155,1555029515,360,0.72,4.319999999999999,inodoro
1555029412,1555029772,360,0.72,4.319999999999999,inodoro
1555029420,1555029994,574,2.9155102040816328,2.725,lavamanos
1555050478,1555050838,360,0.72,4.319999999999999,inodoro
1555050980,1555050986,6,1.99,0.203,lavaplatos
1555051321,1555051818,497,2.9410909090909088,9.04,lavamanos
1555063066,1555063072,6,2.36,0.294,lavamanos
1555063424,1555063432,8,0.4399999999999999,0.034,lavaplatos
1555064088,1555064121,33,1.8116129032258064,1.017,lavamanos
1555085519,1555085528,9,4.962,0.827,lavaplatos
1555086329,1555086371,42,3.407142857142857,0.911,lavamanos
1555087104,1555087464,360,0.72,4.319999999999999,inodoro
1555088692,1555088702,10,2.01,0.344,lavaplatos
1555091483,1555091555,72,1.2681081081081085,1.004,lavamanos
1555092734,1555093094,360,0.72,4.319999999999999,inodoro
1555092903,1555093263,360,0.72,4.319999999999999,inodoro
1555106889,1555106910,21,1.446,0.53,lavamanos
1555107040,1555107400,360,0.72,4.319999999999999,inodoro
1555137573,1555137933,360,0.72,4.319999999999999,inodoro
1555139646,1555139677,31,2.922,1.561,lavaplatos
1555143432,1555143446,14,3.072857142857143,0.782,lavamanos
1555149827,1555149831,4,1.488,0.124,lavamanos
1555161980,1555163199,1219,2.6078260869565217,7.164,lavamanos
1555174628,1555174988,360,0.72,4.319999999999999,inodoro
1555175108,1555175629,521,2.2578571428571426,13.553,lavaplatos
1555180100,1555180200,100,3.2462068965517243,3.602,lavamanos
1555180500,1555180926,426,0.765,3.858,lavaplatos
1555183018,1555183652,634,0.18,2.538,ducha
1555183148,1555183934,786,1.918909090909091,2.358,lavaplatos
1555183692,1555184052,360,0.72,4.319999999999999,inodoro
1555186486,1555186488,2,1.0,0.05,lavaplatos
1555186865,1555187225,360,0.72,4.319999999999999,inodoro
1555186985,1555187024,39,4.095428571428571,2.623,lavamanos
1555259811,1555259818,7,4.885714285714285,0.666,lavaplatos
1555259846,1555259865,19,1.6263157894736842,0.542,lavamanos
1555274497,1555274516,19,1.6588235294117648,0.538,lavamanos
1555277354,1555277714,360,0.72,4.319999999999999,inodoro
1555306566,1555310171,3605,1.4535,9.652,lavaplatos
1555308994,1555309385,391,5.197907949790795,29.654,ducha
1555309152,1555310087,935,3.3216494845360827,6.056,lavamanos
1555311575,1555311935,360,0.72,4.319999999999999,inodoro
1555363034,1555363168,134,4.535454545454545,7.144,lavamanos
1555363105,1555363375,270,1.577142857142857,6.875,lavaplatos
1555365091,1555365249,158,3.500869565217392,7.732,lavamanos
1555365095,1555365455,360,0.72,4.319999999999999,inodoro
1555365230,1555365590,360,0.72,4.319999999999999,inodoro
1555368901,1555368961,60,2.9608695652173918,1.812,lavamanos
1555371215,1555371246,31,0.78,0.281,lavamanos
1555394439,1555395085,646,2.806666666666666,6.371,lavaplatos
1555395635,1555397172,1537,1.3667441860465117,4.568,lavamanos
1555400869,1555400892,23,1.0699999999999998,0.353,lavamanos
1555404136,1555404136,1,0.54,0.009,lavamanos
1555424449,1555424454,5,2.7,0.27,lavaplatos
1555424885,1555425245,360,0.72,4.319999999999999,inodoro
1555428816,1555429003,187,3.129152542372881,8.108,lavamanos
1555429302,1555429327,25,0.54,0.356,lavaplatos
1555435897,1555436257,360,0.72,4.319999999999999,inodoro
1555439218,1555442841,3623,2.02875,4.046,lavaplatos
1555439435,1555439454,19,1.086315789473684,0.35,lavamanos
1555441287,1555441316,29,0.92,0.28,lavamanos
1555444663,1555445023,360,0.72,4.319999999999999,inodoro
1555444837,1555444852,15,0.8474999999999999,0.226,lavamanos
1555479730,1555481320,1590,1.590566037735849,10.626,lavaplatos
1555480560,1555480920,360,0.72,4.319999999999999,inodoro
1555480633,1555480732,99,1.5536170212765958,2.594,lavamanos
1555482053,1555482477,424,3.0341935483870968,6.564,lavamanos
1555482084,1555482381,297,2.984142857142857,14.734,ducha
1555482141,1555482501,360,0.72,4.319999999999999,inodoro
1555483207,1555483334,127,1.7442857142857142,1.621,lavamanos
1555483961,1555483967,6,0.8,0.1,lavamanos
1555517163,1555517176,13,1.892307692307692,0.448,lavamanos
1555518669,1555518703,34,1.18,0.693,lavamanos
1555519309,1555519669,360,0.72,4.319999999999999,inodoro
1555520430,1555520460,30,1.7875862068965516,0.928,lavamanos
1555553841,1555553864,23,1.7217391304347824,0.693,lavamanos
1555553982,1555554342,360,0.72,4.319999999999999,inodoro
1555570241,1555571193,952,1.11,0.185,lavaplatos
1555571047,1555574304,3257,3.0417549167927382,35.415,ducha
1555571071,1555572221,1150,3.931151515151516,40.937,lavamanos
1555571225,1555571585,360,0.72,4.319999999999999,inodoro
1555573533,1555573716,183,1.2776470588235294,1.188,lavamanos
1555677917,1555677932,15,1.032,0.278,lavamanos
1555679678,1555679708,30,0.9085714285714284,0.202,lavaplatos
1555683661,1555683666,5,0.888,0.076,lavaplatos
1555688109,1555691839,3730,5.744025974025973,31.174,ducha
1555688418,1555690106,1688,3.169208633093525,8.312,lavaplatos
1555688526,1555689152,626,1.395,0.403,lavamanos
1555690394,1555690754,360,0.72,4.319999999999999,inodoro
1555691909,1555692141,232,1.522325581395349,4.089,lavamanos
1555693837,1555694074,237,0.6511111111111111,2.123,lavamanos
1555718299,1555718303,4,1.884,0.157,lavaplatos
1555718891,1555719251,360,0.72,4.319999999999999,inodoro
1555718978,1555719002,24,1.065,0.446,lavamanos
1555729457,1555729521,64,1.0927868852459015,1.171,lavamanos
1555746694,1555746731,37,2.1758823529411764,1.317,lavaplatos
1555747049,1555747130,81,3.729,1.457,lavamanos
1555747201,1555747561,360,0.72,4.319999999999999,inodoro
1555747661,1555748021,360,0.72,4.319999999999999,inodoro
1555756076,1555756140,64,1.0453846153846154,0.623,lavamanos
1555758167,1555758185,18,1.0733333333333333,0.342,lavamanos
1555758741,1555759101,360,0.72,4.319999999999999,inodoro
1555759685,1555759713,28,2.4063157894736844,0.825,lavaplatos
1555762169,1555762185,16,1.53375,0.433,lavamanos
1555762618,1555762622,4,0.948,0.079,lavaplatos
1555763685,1555764870,1185,1.6681690140845071,4.449,lavamanos
1555865213,1555865226,13,1.56,0.367,lavamanos
1555876772,1555876777,5,2.79,0.279,lavaplatos
1555876922,1555877282,360,0.72,4.319999999999999,inodoro
1555880904,1555880928,24,1.8533333333333333,0.589,lavamanos
1555910837,1555910919,82,1.5679999999999998,1.338,lavamanos
1555911620,1555911628,8,2.0025,0.291,lavaplatos
1555911733,1555912093,360,0.72,4.319999999999999,inodoro
1555921144,1555921167,23,3.321428571428571,0.795,lavaplatos
1555924978,1555925338,360,0.72,4.319999999999999,inodoro
1555924982,1555925005,23,2.34,0.874,lavamanos
1555928274,1555928311,37,2.013333333333333,1.277,lavamanos
1555931056,1555931558,502,1.185,0.265,lavaplatos
1555933146,1555933189,43,1.5225,0.545,lavamanos
1555934018,1555934989,971,2.5752941176470587,5.405,lavamanos
1555935311,1555935671,360,0.72,4.319999999999999,inodoro
1555935608,1555935652,44,1.308,0.269,lavamanos
1555956877,1555956929,52,1.985,0.998,lavamanos
1555961644,1555961736,92,1.5247058823529411,0.606,lavaplatos
1555966409,1555966494,85,1.703076923076923,0.546,lavaplatos
1555968510,1555968515,5,1.64,0.164,lavaplatos
1555971967,1555972327,360,0.72,4.319999999999999,inodoro
1555975192,1555975195,3,2.565,0.171,lavaplatos
1555975646,1555975675,29,2.273793103448276,1.141,lavamanos
1555976319,1555976361,42,4.811707317073171,3.458,lavamanos
1555997121,1555997481,360,0.72,4.319999999999999,inodoro
1556001680,1556002040,360,0.72,4.319999999999999,inodoro
1556002146,1556002795,649,1.86,12.622,lavaplatos
1556002670,1556002704,34,2.0016,1.286,lavamanos
1556004755,1556004755,1,0.54,0.009,lavamanos
1556007430,1556007471,41,1.1303225806451611,0.644,lavamanos
1556010092,1556010308,216,2.7423529411764704,13.179,lavaplatos
1556010606,1556010662,56,2.262857142857143,1.241,lavamanos
1556012833,1556013730,897,1.596951219512195,8.518,lavamanos
1556024110,1556026894,2784,2.06123595505618,28.988,lavaplatos
1556025827,1556026187,360,0.72,4.319999999999999,inodoro
1556029284,1556029299,15,0.97875,0.261,lavamanos
1556029407,1556029671,264,2.853333333333333,12.525,lavaplatos
1556032463,1556032467,4,0.6599999999999999,0.037,lavaplatos
1556032492,1556032494,2,1.2,0.06,lavamanos
1556033219,1556034301,1082,3.140287081339713,37.457,ducha
1556033264,1556033947,683,2.906776859504132,27.051,lavamanos
1556034959,1556035319,360,0.72,4.319999999999999,inodoro
1556035140,1556035895,755,1.2536842105263155,1.947,lavamanos
1556047062,1556047113,51,0.9832258064516128,0.617,lavamanos
1556047335,1556049815,2480,3.0790163934426227,22.452,lavaplatos
1556049023,1556049023,1,0.54,0.009,lavamanos
1556085129,1556085489,360,0.72,4.319999999999999,inodoro
1556088063,1556088423,360,0.72,4.319999999999999,inodoro
1556127566,1556127931,365,1.411875,0.906,lavamanos
1556127663,1556127663,1,0.8999999999999999,0.015,lavaplatos
1556131954,1556132314,360,0.72,4.319999999999999,inodoro
1556182879,1556182891,12,1.44,0.317,lavamanos
1556184101,1556184118,17,1.7299999999999998,0.197,lavaplatos
1556184163,1556184177,14,1.296923076923077,0.312,lavamanos
1556184928,1556184971,43,1.0623529411764707,0.373,lavamanos
1556226895,1556226931,36,2.4975,1.11,lavaplatos
1556226975,1556227335,360,0.72,4.319999999999999,inodoro
1556257222,1556257582,360,0.72,4.319999999999999,inodoro
1556257476,1556257864,388,2.4,15.238,lavaplatos
1556261542,1556261565,23,0.42,0.063,lavamanos
1556261707,1556262067,360,0.72,4.319999999999999,inodoro
1556266906,1556271882,4976,2.423219178082192,30.25,lavaplatos
1556272056,1556272648,592,0.9333333333333332,0.248,lavamanos
1556272697,1556273057,360,0.72,4.319999999999999,inodoro
1556274236,1556274242,6,0.8485714285714285,0.099,lavamanos
1556275111,1556275426,315,2.1414285714285715,1.887,lavamanos
1556281252,1556281346,94,5.236551724137931,8.077,lavaplatos
1556282003,1556282072,69,1.56,1.287,lavamanos
1556283834,1556283839,5,0.94,0.094,lavamanos
1556293097,1556293364,267,4.893839999999999,21.584,ducha
1556293192,1556293262,70,2.6236363636363635,3.09,lavamanos
1556294545,1556295171,626,0.933,1.083,lavamanos
1556295120,1556295480,360,0.72,4.319999999999999,inodoro
1556295524,1556295884,360,0.72,4.319999999999999,inodoro
1556317726,1556317825,99,1.047,0.687,lavamanos
1556318756,1556318878,122,3.6576,2.522,lavamanos
1556320264,1556320276,12,1.2,0.098,lavaplatos
1556321691,1556322051,360,0.72,4.319999999999999,inodoro
1556325469,1556325560,91,4.646470588235294,2.976,lavamanos
1556325600,1556325960,360,0.72,4.319999999999999,inodoro
1556325680,1556326040,360,0.72,4.319999999999999,inodoro
1556330915,1556331275,360,0.72,4.319999999999999,inodoro
1556331446,1556333435,1989,2.201,3.697,lavaplatos
1556331657,1556331707,50,2.718260869565217,1.253,lavamanos
1556353416,1556353754,338,3.4689795918367343,9.117,lavaplatos
1556353433,1556353654,221,0.4679999999999999,0.039,lavamanos
1556354855,1556356385,1530,1.4506153846153846,8.923,lavamanos
1556354882,1556355242,360,0.72,4.319999999999999,inodoro
1556357118,1556357202,84,0.6109090909090908,0.419,lavamanos
1556358652,1556359012,360,0.72,4.319999999999999,inodoro
1556393688,1556393791,103,2.177142857142857,3.455,lavaplatos
1556394135,1556394257,122,1.38,0.778,lavamanos
1556394657,1556395017,360,0.72,4.319999999999999,inodoro
1556395070,1556395283,213,3.5127272727272727,6.239,lavamanos
1556395115,1556395475,360,0.72,4.319999999999999,inodoro
1556395994,1556396010,16,0.952,0.242,lavamanos
1556397945,1556397995,50,4.812499999999999,2.255,lavamanos
1556404473,1556404475,2,1.06,0.053,lavaplatos
1556404782,1556404954,172,0.9463636363636364,3.037,lavamanos
1556406023,1556406383,360,0.72,4.319999999999999,inodoro
1556432208,1556432218,10,0.8099999999999999,0.158,lavamanos
1556432804,1556432806,2,5.1,0.255,lavaplatos
1556435801,1556436072,271,1.538181818181818,5.896,lavamanos
1556449456,1556449467,11,0.7749999999999999,0.155,lavamanos
1556449926,1556450231,305,2.107058823529412,3.751,lavaplatos
1556450968,1556451328,360,0.72,4.319999999999999,inodoro
1556450985,1556451203,218,5.135121951219512,18.641,ducha
1556451716,1556451785,69,1.5236363636363637,1.782,lavamanos
1556453662,1556453744,82,1.0766666666666664,0.866,lavamanos
1556455994,1556456354,360,0.72,4.319999999999999,inodoro
1556490223,1556490238,15,0.96,0.122,lavaplatos
1556492214,1556492230,16,0.8474999999999999,0.241,lavamanos
1556516562,1556518598,2036,1.59375,9.797,lavaplatos
1556516618,1556517455,837,1.7903076923076922,4.354,lavamanos
1556517910,1556518270,360,0.72,4.319999999999999,inodoro
1556518884,1556518920,36,1.8176470588235287,1.1,lavamanos
1556519607,1556519625,18,1.51875,0.437,lavamanos
1556646405,1556646422,17,0.86,0.237,lavamanos
1556647394,1556648888,1494,2.3811111111111107,19.86,lavaplatos
1556647428,1556647788,360,0.72,4.319999999999999,inodoro
1556678360,1556678411,51,0.9110204081632652,0.789,lavamanos
1556697100,1556697460,360,0.72,4.319999999999999,inodoro
1556698376,1556699959,1583,1.9810526315789476,6.389,lavaplatos
1556699839,1556703889,4050,3.1307322175732213,54.099,ducha
1556700393,1556700499,106,4.307368421052631,3.271,lavamanos
1556700792,1556701152,360,0.72,4.319999999999999,inodoro
1556702763,1556703847,1084,2.898111455108359,48.605,lavamanos
1556704670,1556704711,41,1.6326315789473682,1.15,lavamanos
1556705479,1556706232,753,1.8273333333333333,6.719,lavamanos
1556706853,1556707213,360,0.72,4.319999999999999,inodoro
1556738408,1556738427,19,0.6821052631578947,0.229,lavamanos
1556746234,1556746255,21,1.068,0.378,lavamanos
1556746331,1556746691,360,0.72,4.319999999999999,inodoro
1556753877,1556754020,143,2.892,3.344,lavamanos
1556776013,1556776373,360,0.72,4.319999999999999,inodoro
1556776261,1556777198,937,1.7458536585365854,7.991,lavaplatos
1556778584,1556778818,234,1.4787401574803147,4.402,lavamanos
1556779313,1556779673,360,0.72,4.319999999999999,inodoro
1556779433,1556779989,556,1.4230434782608694,1.632,lavamanos
1556780355,1556780416,61,2.736,1.636,lavaplatos
1556821521,1556821521,1,1.3199999999999998,0.022,lavamanos
1556822331,1556830036,7705,2.0418677042801554,38.784,lavaplatos
1556823483,1556823843,360,0.72,4.319999999999999,inodoro
1556826349,1556826364,15,2.448,0.661,lavamanos
1556862621,1556862677,56,0.708,0.267,lavamanos
1556862715,1556863075,360,0.72,4.319999999999999,inodoro
1556863216,1556864734,1518,0.7297959183673469,7.225,lavaplatos
1556865612,1556865914,302,1.9266176470588237,6.064,lavamanos
1556866784,1556867791,1007,1.6016949152542372,2.487,lavamanos
1556867567,1556867927,360,0.72,4.319999999999999,inodoro
1556868299,1556868302,3,1.02,0.071,lavaplatos
1556908559,1556913093,4534,2.614172185430464,25.201,lavaplatos
1556910237,1556910237,1,0.36,0.006,lavamanos
1556948143,1556948162,19,2.829473684210526,0.952,lavamanos
1556948206,1556948566,360,0.72,4.319999999999999,inodoro
1556948759,1556948766,7,1.3114285714285714,0.186,lavaplatos
1556953176,1556953536,360,0.72,4.319999999999999,inodoro
1556956955,1556957106,151,0.255,1.645,lavamanos
1556958103,1556958404,301,3.827746478873239,19.201,ducha
1556958197,1556958275,78,3.7875,4.354,lavamanos
1556959312,1556959341,29,1.305,0.429,lavamanos
1556960412,1556961300,888,1.63,7.291,lavamanos
1556974098,1556975357,1259,4.1456,8.91,lavaplatos
1556980214,1556980309,95,2.598333333333333,1.867,lavamanos
1556980343,1556980703,360,0.72,4.319999999999999,inodoro
1556998116,1556998141,25,1.5499999999999998,0.676,lavamanos
1556998268,1556999925,1657,2.47695652173913,3.33,lavaplatos
1557032577,1557032580,3,0.585,0.039,lavamanos
1557033060,1557033065,5,1.43,0.143,lavaplatos
1557041484,1557041844,360,0.72,4.319999999999999,inodoro
1557043448,1557043784,336,1.7121052631578948,3.599,lavamanos
1557044610,1557044877,267,1.5725806451612905,3.503,lavamanos
1557045505,1557045566,61,0.59,0.271,lavamanos
1557164167,1557164257,90,3.7885714285714287,4.928,lavaplatos
1557165075,1557165079,4,1.692,0.141,lavamanos
1557166670,1557174298,7628,2.381123595505618,101.613,lavaplatos
1557167376,1557167383,7,1.19,0.143,lavamanos
1557169668,1557170508,840,3.108,14.633,lavamanos
1557169715,1557170075,360,0.72,4.319999999999999,inodoro
1557170017,1557170377,360,0.72,4.319999999999999,inodoro
1557170525,1557170885,360,0.72,4.319999999999999,inodoro
1557174619,1557175277,658,2.5254545454545454,1.14,lavamanos
1557177663,1557181323,3660,2.398874296435272,67.963,lavaplatos
1557178799,1557178869,70,2.841,1.147,lavamanos
1557182892,1557183252,360,0.72,4.319999999999999,inodoro
1557183220,1557183580,360,0.72,4.319999999999999,inodoro
1557183428,1557183494,66,0.943728813559322,1.007,lavamanos
1557183648,1557184008,360,0.72,4.319999999999999,inodoro
1557184426,1557184786,360,0.72,4.319999999999999,inodoro
1557184660,1557184747,87,3.06,1.57,lavamanos
1557223061,1557223486,425,0.8717647058823529,0.471,lavamanos
1557229081,1557229441,360,0.72,4.319999999999999,inodoro
1557229085,1557229445,360,0.72,4.319999999999999,inodoro
1557251604,1557251647,43,2.153333333333333,0.942,lavamanos
1557251648,1557252008,360,0.72,4.319999999999999,inodoro
1557261812,1557261953,141,2.3657142857142857,5.466,lavamanos
1557292463,1557292676,213,2.170181818181818,6.521,lavaplatos
1557292998,1557293358,360,0.72,4.319999999999999,inodoro
1557293229,1557293783,554,1.5329411764705885,4.737,lavamanos
1557330067,1557330102,35,2.314285714285714,0.635,lavamanos
1557332904,1557333264,360,0.72,4.319999999999999,inodoro
1557332916,1557333150,234,2.285853658536585,4.563,lavamanos
1557354854,1557354864,10,2.061818181818182,0.378,lavaplatos
1557355226,1557355444,218,1.3885714285714286,2.417,lavamanos
1557378569,1557378929,360,0.72,4.319999999999999,inodoro
1557378949,1557380328,1379,1.3753846153846154,0.298,lavaplatos
1557379410,1557380531,1121,1.3763855421686748,5.339,lavamanos
1557419858,1557419873,15,2.388,0.606,lavamanos
1557422590,1557425229,2639,2.210625,16.941,lavaplatos
1557423882,1557424242,360,0.72,4.319999999999999,inodoro
1557426968,1557427328,360,0.72,4.319999999999999,inodoro
1557433947,1557433956,9,0.678,0.113,lavaplatos
1557436053,1557436413,360,0.72,4.319999999999999,inodoro
1557436965,1557437236,271,1.392,1.872,lavamanos
1557436995,1557437608,613,4.152349726775956,42.412,ducha
1557439251,1557439298,47,0.6675,0.18,lavaplatos
1557439362,1557439426,64,1.962,0.547,lavamanos
1557467759,1557468637,878,1.5015384615384617,1.43,lavaplatos
1557469181,1557470534,1353,1.92140350877193,6.064,lavamanos
1557471996,1557472356,360,0.72,4.319999999999999,inodoro
1557472165,1557472525,360,0.72,4.319999999999999,inodoro
1557472300,1557472362,62,1.26,0.383,lavamanos
1557473467,1557473827,360,0.72,4.319999999999999,inodoro
1557763013,1557763015,2,2.96,0.148,lavaplatos
1557768396,1557768756,360,0.72,4.319999999999999,inodoro
1557768474,1557768482,8,0.6,0.042,lavamanos
1557771364,1557771366,2,0.74,0.037,lavaplatos
1557774932,1557775121,189,0.912,0.1,lavamanos
1557775765,1557777735,1970,2.127640449438202,5.016,lavaplatos
1557812255,1557812615,360,0.72,4.319999999999999,inodoro
1557812823,1557812838,15,1.5085714285714285,0.241,lavaplatos
1557813263,1557813693,430,5.207722007722007,24.587,ducha
1557813468,1557813553,85,3.638918918918919,4.851,lavamanos
1557814372,1557814579,207,2.1369230769230767,1.543,lavamanos
1557815021,1557815381,360,0.72,4.319999999999999,inodoro
1557815364,1557815377,13,0.8815384615384615,0.202,lavamanos
1557826364,1557826369,5,0.94,0.094,lavamanos
1557832370,1557832388,18,2.22,0.344,lavamanos
1557861404,1557861416,12,0.3342857142857142,0.051,lavaplatos
1557865342,1557865374,32,1.632,0.601,lavamanos
1557866008,1557866012,4,0.96,0.073,lavamanos
1557866033,1557866393,360,0.72,4.319999999999999,inodoro
1557866216,1557866576,360,0.72,4.319999999999999,inodoro
1557898545,1557898561,16,0.5828571428571427,0.09,lavamanos
1557898684,1557899044,360,0.72,4.319999999999999,inodoro
1557899093,1557899284,191,1.8075,1.269,lavaplatos
1557899550,1557899661,111,3.4490909090909088,5.754,lavamanos
1557899653,1557903075,3422,3.896688741721854,49.908,ducha
1557901335,1557902231,896,1.6193939393939394,7.504,lavamanos
1557902996,1557903078,82,2.223333333333333,1.535,lavamanos
1557903196,1557903236,40,2.3857894736842105,1.635,lavaplatos
1557953339,1557953353,14,1.8257142857142856,0.462,lavamanos
1557953798,1557954158,360,0.72,4.319999999999999,inodoro
1557954030,1557954167,137,2.2965217391304344,3.546,lavaplatos
1557954309,1557954328,19,2.04,0.607,lavamanos
1557959621,1557959855,234,1.675,0.703,lavamanos
1557959660,1557959803,143,3.0472058823529413,7.317,lavaplatos
1557959844,1557959987,143,3.0482926829268293,5.602,ducha
1557985824,1557986003,179,1.99875,5.611,lavaplatos
1557985830,1557985830,1,0.78,0.013,lavamanos
1557986676,1557987036,360,0.72,4.319999999999999,inodoro
1557987102,1557987405,303,2.51801652892562,5.475,lavamanos
1557988100,1557988760,660,1.3199999999999998,1.707,lavamanos
1558087924,1558087952,28,2.72,1.145,lavamanos
1558096788,1558096807,19,1.02,0.288,lavaplatos
1558097465,1558097511,46,4.935428571428571,3.085,lavamanos
1558099666,1558099690,24,1.3257142857142856,0.499,lavamanos
1558100276,1558100636,360,0.72,4.319999999999999,inodoro
1558116063,1558117200,1137,3.175609756097561,2.31,lavaplatos
1558118341,1558118860,519,1.8909090909090909,2.249,lavamanos
1558138578,1558139635,1057,1.8292857142857144,10.851,lavamanos
1558142563,1558142923,360,0.72,4.319999999999999,inodoro
1558159001,1558164914,5913,1.5717857142857143,4.4,lavaplatos
1558165538,1558166017,479,3.636057692307692,25.647,lavamanos
1558165682,1558166012,330,3.735670103092784,21.064,ducha
1558167517,1558167664,147,1.896923076923077,1.344,lavamanos
1558168715,1558168816,101,1.83,0.985,lavamanos
1558170379,1558170382,3,1.125,0.075,lavaplatos
1558172182,1558172201,19,2.908421052631579,0.977,lavamanos
1558174512,1558174872,360,0.72,4.319999999999999,inodoro
1558208257,1558208656,399,1.2972972972972971,2.542,lavamanos
1558209697,1558209762,65,1.1257142857142857,0.958,lavaplatos
1558212879,1558213239,360,0.72,4.319999999999999,inodoro
1558213060,1558213121,61,1.556,0.696,lavamanos
1558235218,1558235578,360,0.72,4.319999999999999,inodoro
1558236060,1558236335,275,0.6019354838709677,0.66,lavamanos
1558236085,1558236445,360,0.72,4.319999999999999,inodoro
1558252813,1558253173,360,0.72,4.319999999999999,inodoro
1558252902,1558252923,21,0.56,0.136,lavamanos
1558253266,1558253735,469,1.92,3.841,lavaplatos
1558253753,1558253784,31,0.705,0.103,lavamanos
1558255608,1558255625,17,0.825,0.177,lavamanos
1558256277,1558256331,54,1.995,0.536,lavaplatos
1558261784,1558261789,5,0.47,0.047,lavamanos
1558262164,1558262289,125,1.935,2.368,lavaplatos
1558262609,1558262651,42,2.742,1.928,lavamanos
1558263962,1558263994,32,1.0238709677419355,0.567,lavamanos
1558266267,1558266627,360,0.72,4.319999999999999,inodoro
1558266735,1558267095,360,0.72,4.319999999999999,inodoro
1558266914,1558266944,30,2.293846153846154,0.695,lavamanos
1558268228,1558268579,351,3.968756756756756,17.173,lavaplatos
1558268411,1558268422,11,1.42,0.284,lavamanos
1558270192,1558270586,394,1.325,0.809,lavamanos
1558270879,1558270895,16,1.4475,0.211,lavaplatos
1558273830,1558273837,7,1.812,0.175,lavaplatos
1558274370,1558274398,28,1.1869565217391305,0.508,lavamanos
1558274769,1558275129,360,0.72,4.319999999999999,inodoro
1558281767,1558281769,2,1.34,0.067,lavaplatos
1558283271,1558283631,360,0.72,4.319999999999999,inodoro
1558288738,1558289413,675,3.017142857142857,1.216,lavaplatos
1558290038,1558290045,7,1.4025,0.187,lavamanos
1558290062,1558290422,360,0.72,4.319999999999999,inodoro
1558297270,1558297630,360,0.72,4.319999999999999,inodoro
1558300443,1558300512,69,2.544,2.637,lavaplatos
1558335601,1558335961,360,0.72,4.319999999999999,inodoro
1558336036,1558336396,360,0.72,4.319999999999999,inodoro
1558336345,1558336705,360,0.72,4.319999999999999,inodoro
1558336557,1558336650,93,5.316,7.803,ducha
1558336719,1558337079,360,0.72,4.319999999999999,inodoro
1558338449,1558339055,606,2.3246511627906976,9.445,lavaplatos
1558340401,1558340518,117,1.7999999999999998,0.521,lavamanos
1558342209,1558344230,2021,2.598367346938776,11.907,lavaplatos
1558349926,1558350286,360,0.72,4.319999999999999,inodoro
1558351272,1558351847,575,3.187964601769912,8.792,lavaplatos
1558355519,1558355766,247,2.968181818181818,9.59,lavamanos
1558362548,1558362655,107,2.521428571428572,4.258,lavaplatos
1558363087,1558363447,360,0.72,4.319999999999999,inodoro
1558364420,1558364780,360,0.72,4.319999999999999,inodoro
1558369752,1558369758,6,2.725714285714285,0.318,lavaplatos
1558371635,1558372047,412,3.2668085106382976,18.44,lavaplatos
1558381257,1558382421,1164,1.686,2.274,lavaplatos
1558383941,1558384301,360,0.72,4.319999999999999,inodoro
1558415361,1558415363,2,0.84,0.042,lavamanos
1558417769,1558418271,502,1.7425,8.609,lavaplatos
1558418101,1558418813,712,7.02268156424581,62.61,ducha
1558418697,1558419042,345,3.126666666666667,15.032,lavamanos
1558419553,1558419913,360,0.72,4.319999999999999,inodoro
1558419696,1558419762,66,0.9347368421052632,0.789,lavamanos
1558420440,1558420580,140,1.2214285714285713,5.656,lavamanos
1558420651,1558421011,360,0.72,4.319999999999999,inodoro
1558421177,1558421238,61,1.6414285714285717,1.521,lavaplatos
1558421276,1558421295,19,1.1766666666666663,0.375,lavamanos
1558456955,1558457582,627,1.1016666666666666,0.888,lavamanos
1558457112,1558457116,4,0.96,0.066,lavaplatos
1558465926,1558465942,16,0.99,0.266,lavamanos
1558466783,1558470539,3756,2.53046511627907,29.235,lavaplatos
1558470999,1558471413,414,0.8364705882352941,0.653,lavamanos
1558503336,1558503352,16,1.08,0.152,lavamanos
1558503922,1558504297,375,0.787741935483871,2.199,lavaplatos
1558504795,1558505466,671,1.8216666666666663,3.518,lavamanos
1558504989,1558505403,414,6.422295918367347,44.511,ducha
1558506725,1558507760,1035,3.11664,12.148,lavamanos
1558516160,1558516520,360,0.72,4.319999999999999,inodoro
1558557727,1558558352,625,1.4364705882352942,0.871,lavamanos
1558590662,1558590858,196,2.1083720930232555,4.296,lavaplatos
1558592107,1558592467,360,0.72,4.319999999999999,inodoro
1558594248,1558595790,1542,3.508387096774193,7.231,lavaplatos
1558595066,1558595293,227,0.39,2.499,ducha
1558597633,1558597650,17,0.915,0.117,lavamanos
1558598279,1558598520,241,2.096363636363636,5.049,lavamanos
1558599137,1558599399,262,1.0714285714285714,3.244,lavamanos
1558599495,1558599504,9,2.66,0.437,lavaplatos
1558600693,1558601143,450,4.30611825192802,32.204,ducha
1558600727,1558601133,406,3.7814457831325297,5.622,lavamanos
1558601886,1558602693,807,1.562142857142857,2.219,lavamanos
1558603545,1558603905,360,0.72,4.319999999999999,inodoro
1558624465,1558624964,499,1.0264285714285717,1.023,lavamanos
1558628532,1558628892,360,0.72,4.319999999999999,inodoro
1558650473,1558650492,19,1.0933333333333333,0.352,lavamanos
1558673160,1558673168,8,0.63,0.095,lavamanos
1558676085,1558676445,360,0.72,4.319999999999999,inodoro
1558676570,1558677031,461,2.293090909090909,7.117,lavaplatos
1558677595,1558678055,460,1.302857142857143,4.254,lavamanos
1558678784,1558679086,302,1.141875,1.346,lavamanos
1558680201,1558680561,360,0.72,4.319999999999999,inodoro
1558716653,1558716661,8,1.2066666666666666,0.181,lavamanos
1558718324,1558718516,192,1.68,2.125,lavamanos
1558735916,1558735963,47,1.209,0.481,lavamanos
1558736161,1558736521,360,0.72,4.319999999999999,inodoro
1558751898,1558751957,59,0.7873684210526315,0.787,lavamanos
1558752041,1558752401,360,0.72,4.319999999999999,inodoro
1558767413,1558767952,539,2.055228426395939,15.33,lavaplatos
1558769475,1558769561,86,2.1151807228915662,3.078,lavamanos
1558770103,1558770463,360,0.72,4.319999999999999,inodoro
1558770215,1558770367,152,1.167857142857143,1.063,lavamanos
1558770451,1558772230,1779,2.9071698113207547,3.008,lavaplatos
1558771063,1558771114,51,1.418,0.845,lavamanos
1558772492,1558772571,79,2.360307692307692,2.739,lavamanos
1558775086,1558775446,360,0.72,4.319999999999999,inodoro
1558776133,1558776493,360,0.72,4.319999999999999,inodoro
1558787155,1558790243,3088,1.3878260869565218,11.632,lavaplatos
1558792310,1558792318,8,2.0828571428571427,0.247,lavaplatos
1558792769,1558793129,360,0.72,4.319999999999999,inodoro
1558793912,1558793968,56,3.964444444444444,3.781,lavamanos
1558794128,1558794488,360,0.72,4.319999999999999,inodoro
1558794142,1558794310,168,0.6839999999999999,0.403,lavaplatos
1558798137,1558798497,360,0.72,4.319999999999999,inodoro
1558809319,1558809679,360,0.72,4.319999999999999,inodoro
1558817673,1558818033,360,0.72,4.319999999999999,inodoro
1558852869,1558853229,360,0.72,4.319999999999999,inodoro
1558979379,1558979488,109,0.5945454545454545,6.547,ducha
1558979475,1558979480,5,0.516,0.045,lavamanos
1558979541,1558980457,916,1.2017142857142855,2.895,lavaplatos
1558980090,1558980269,179,0.7936363636363636,1.662,lavamanos
1558986270,1558986279,9,1.96,0.185,lavamanos
1558986478,1558986484,6,1.2799999999999998,0.165,lavaplatos
1558988549,1558988679,130,1.5239999999999998,1.149,lavaplatos
1558988869,1558988930,61,1.096,0.478,lavamanos
1558988998,1558989358,360,0.72,4.319999999999999,inodoro
1558994218,1558994218,1,0.78,0.013,lavaplatos
1558997182,1558997211,29,0.825,0.321,lavamanos
1558997297,1558997657,360,0.72,4.319999999999999,inodoro
1559020000,1559020471,471,1.6297959183673467,6.55,lavaplatos
1559020964,1559022747,1783,2.1756650246305416,8.057,lavamanos
1559021230,1559022133,903,5.64663829787234,29.277,ducha
1559021520,1559021880,360,0.72,4.319999999999999,inodoro
1559022958,1559023318,360,0.72,4.319999999999999,inodoro
1559145641,1559146001,360,0.72,4.319999999999999,inodoro
1559145911,1559146072,161,1.771764705882353,2.504,lavamanos
1559146322,1559146681,359,2.7818181818181817,10.913,lavaplatos
1559147224,1559147584,360,0.72,4.319999999999999,inodoro
1559147274,1559148013,739,1.808936170212766,4.004,lavamanos
1559171607,1559171639,32,0.8514285714285713,0.338,lavamanos
1559196232,1559196259,27,2.184,0.483,lavamanos
1559196256,1559196616,360,0.72,4.319999999999999,inodoro
1559198275,1559198635,360,0.72,4.319999999999999,inodoro
1559198642,1559201301,2659,2.155,11.669,lavaplatos
1559199514,1559199961,447,1.7882242990654205,3.486,lavamanos
1559199934,1559200294,360,0.72,4.319999999999999,inodoro
1559202107,1559202160,53,1.9872,1.763,lavamanos
1559203747,1559208025,4278,1.1860869565217391,13.212,lavaplatos
1559204442,1559204502,60,0.93,0.365,lavamanos
1559206709,1559207069,360,0.72,4.319999999999999,inodoro
1559208270,1559208630,360,0.72,4.319999999999999,inodoro
1559212164,1559214163,1999,2.786896551724138,13.741,lavaplatos
1559227017,1559227377,360,0.72,4.319999999999999,inodoro
1559227033,1559228317,1284,5.675833333333333,31.93,ducha
1559227138,1559228301,1163,3.613076923076923,11.36,lavamanos
1559250808,1559251168,360,0.72,4.319999999999999,inodoro
1559281653,1559282013,360,0.72,4.319999999999999,inodoro
1559282137,1559282275,138,0.72,0.298,ducha
1559284894,1559285254,360,0.72,4.319999999999999,inodoro
1559366596,1559366956,360,0.72,4.319999999999999,inodoro
1559372500,1559374069,1569,2.0217391304347827,0.961,lavaplatos
1559372645,1559373005,360,0.72,4.319999999999999,inodoro
1559375912,1559376875,963,4.249787234042553,3.548,lavaplatos
1559378513,1559378873,360,0.72,4.319999999999999,inodoro
1559379842,1559380202,360,0.72,4.319999999999999,inodoro
1559382342,1559387958,5616,2.334915254237288,71.698,lavaplatos
1559387447,1559387900,453,0.56,5.601,ducha
1559390643,1559396989,6346,2.601935483870968,84.493,lavaplatos
1559396044,1559396404,360,0.72,4.319999999999999,inodoro
1559396070,1559396430,360,0.72,4.319999999999999,inodoro
1559397299,1559397659,360,0.72,4.319999999999999,inodoro
1559401314,1559401334,20,1.1676923076923076,0.338,lavaplatos
1559406788,1559406791,3,2.025,0.135,lavaplatos
1559412890,1559412915,25,3.5942857142857143,1.34,lavaplatos
1559416120,1559416151,31,0.976,0.326,lavamanos
1559423290,1559423308,18,1.81,0.414,lavaplatos
1559423725,1559424085,360,0.72,4.319999999999999,inodoro
1559440489,1559440492,3,0.6,0.034,lavamanos
1559441519,1559441879,360,0.72,4.319999999999999,inodoro
1559441633,1559441684,51,2.9175,2.547,lavamanos
1559460126,1559462105,1979,2.1683168316831685,5.535,lavaplatos
1559464205,1559464222,17,2.0047058823529413,0.608,lavamanos
1559469238,1559469598,360,0.72,4.319999999999999,inodoro
1559470102,1559470414,312,6.785324232081911,35.349,ducha
1559470106,1559472023,1917,2.0276855895196504,11.783,lavamanos
1559483079,1559483217,138,0.6719999999999999,0.901,lavamanos
1559498008,1559498053,45,0.7926315789473685,0.37,lavamanos
1559498096,1559498456,360,0.72,4.319999999999999,inodoro
1559498156,1559498516,360,0.72,4.319999999999999,inodoro
1559512182,1559512199,17,1.5825,0.459,lavamanos
1559512441,1559512805,364,0.8563636363636363,0.865,lavaplatos
1559540605,1559540613,8,1.6424999999999998,0.268,lavamanos
1559540897,1559540912,15,0.828,0.171,lavaplatos
1559541509,1559542151,642,1.481938775510204,7.545,lavamanos
1559541514,1559541756,242,5.167894736842105,20.829,ducha
1559543242,1559544096,854,1.751111111111111,3.206,lavamanos
1559544357,1559544377,20,4.717894736842105,1.586,lavaplatos
1559585221,1559585264,43,1.512857142857143,0.496,lavamanos
1559587154,1559587190,36,1.3885714285714286,0.399,lavamanos
1559590444,1559590538,94,1.372,0.643,lavamanos
1559590516,1559590876,360,0.72,4.319999999999999,inodoro
1559590554,1559592246,1692,3.104,27.608,lavaplatos
1559592415,1559592470,55,2.096,0.924,lavamanos
1559592457,1559592817,360,0.72,4.319999999999999,inodoro
1559603481,1559604078,597,2.627294117647059,7.7,lavamanos
1559631798,1559632611,813,2.556774193548387,8.997,lavaplatos
1559633744,1559634104,360,0.72,4.319999999999999,inodoro
1559637113,1559637185,72,1.2785714285714285,1.176,lavaplatos
1559637902,1559637956,54,1.354736842105263,0.969,lavamanos
1559639532,1559639892,360,0.72,4.319999999999999,inodoro
1559641476,1559642289,813,0.8638167938931297,5.166,lavamanos
1559647120,1559647133,13,5.710909090909091,1.116,lavaplatos
1559647355,1559647427,72,1.8544186046511628,1.554,lavamanos
1559651307,1559654095,2788,3.0469035532994924,22.441,lavaplatos
1559651457,1559651523,66,0.8025,0.332,lavamanos
1559654310,1559654670,360,0.72,4.319999999999999,inodoro
1559654495,1559655229,734,1.3513043478260869,3.345,lavamanos
1559661547,1559661612,65,3.603,1.467,lavamanos
1559670610,1559670660,50,0.6719999999999999,0.761,lavaplatos
1559670970,1559671149,179,2.136,6.081,lavamanos
1559670974,1559671147,173,5.6475,16.41,ducha
1559686910,1559687173,263,2.493103448275862,6.259,lavaplatos
1559687205,1559687224,19,0.8968421052631579,0.299,lavamanos
1559687275,1559687635,360,0.72,4.319999999999999,inodoro
1559714670,1559714745,75,0.6171428571428572,0.3,lavamanos
1559715211,1559715441,230,1.7854945054945055,4.23,lavaplatos
1559716482,1559716842,360,0.72,4.319999999999999,inodoro
1559720852,1559722462,1610,2.136875,4.493,lavaplatos
1559728360,1559728925,565,1.9515,9.914,lavaplatos
1559730048,1559730594,546,6.648932038834952,60.579,ducha
1559730053,1559730155,102,1.8197872340425527,3.13,lavamanos
1559731295,1559731400,105,0.9075,0.682,lavamanos
1559731824,1559731836,12,0.6,0.066,lavaplatos
1559733782,1559734625,843,1.9904347826086957,6.561,lavamanos
1559735677,1559736037,360,0.72,4.319999999999999,inodoro
1559768612,1559768657,45,0.9670588235294116,0.348,lavamanos
1559799343,1559799703,360,0.72,4.319999999999999,inodoro
1559799792,1559799800,8,2.5125,0.386,lavaplatos
1559800024,1559800384,360,0.72,4.319999999999999,inodoro
1559800286,1559800534,248,5.149655172413794,21.074,ducha
1559800291,1559800524,233,3.079830508474576,6.633,lavamanos
1559802422,1559803278,856,0.9766666666666668,9.634,lavamanos
1559803785,1559804138,353,1.5857142857142856,3.159,lavaplatos
1559805332,1559805692,360,0.72,4.319999999999999,inodoro
1559841523,1559842105,582,1.8259459459459455,1.463,lavamanos
1559841717,1559841889,172,5.283703703703704,15.12,ducha
1559842366,1559842395,29,3.155,1.339,lavaplatos
1559842551,1559842911,360,0.72,4.319999999999999,inodoro
1559863143,1559864307,1164,1.3628571428571428,0.537,lavaplatos
1559863496,1559863860,364,1.2795,1.161,lavamanos
1559863692,1559864052,360,0.72,4.319999999999999,inodoro
1559868257,1559868617,360,0.72,4.319999999999999,inodoro
1559868431,1559868439,8,0.8,0.12,lavamanos
1559869987,1559870084,97,1.7905263157894735,1.872,lavamanos
1559870090,1559870450,360,0.72,4.319999999999999,inodoro
1559890576,1559890589,13,0.12,0.028,lavamanos
1559890751,1559892153,1402,1.7447244094488188,15.318,lavaplatos
1559892079,1559892127,48,0.6599999999999999,0.282,lavamanos
1559892687,1559893047,360,0.72,4.319999999999999,inodoro
1559895066,1559895426,360,0.72,4.319999999999999,inodoro
1559898062,1559898831,769,3.300967741935484,8.901,lavaplatos
1559902218,1559902578,360,0.72,4.319999999999999,inodoro
1559903810,1559903846,36,1.5171428571428571,0.492,lavamanos
1559907513,1559907873,360,0.72,4.319999999999999,inodoro
1559907747,1559908947,1200,2.0725,1.203,lavaplatos
1559911631,1559912233,602,2.571578947368421,12.926,lavaplatos
1559911916,1559912276,360,0.72,4.319999999999999,inodoro
1559913383,1559913743,360,0.72,4.319999999999999,inodoro
1559916324,1559916983,659,3.098,21.946,lavaplatos
1559916805,1559917338,533,1.2335294117647058,1.021,lavamanos
1559918032,1559918444,412,1.9817142857142855,5.243,lavamanos
1559918046,1559918364,318,5.745551839464882,30.308,ducha
1559920316,1559920613,297,1.7113513513513512,10.564,lavamanos
1559920799,1559921159,360,0.72,4.319999999999999,inodoro
1559921161,1559922187,1026,2.731764705882353,0.828,lavaplatos
1559921635,1559921995,360,0.72,4.319999999999999,inodoro
1559923305,1559923344,39,2.0066666666666664,1.274,lavamanos
1559938082,1559938442,360,0.72,4.319999999999999,inodoro
1559941199,1559941263,64,1.0,0.372,lavamanos
1559976883,1559977059,176,1.7109677419354838,3.066,lavaplatos
1559977116,1559977139,23,1.0278260869565217,0.414,lavamanos
1559977388,1559977748,360,0.72,4.319999999999999,inodoro
1559980698,1559980706,8,2.7525,0.414,lavaplatos
1559987556,1559987564,8,0.57,0.063,lavaplatos
1559987836,1559989090,1254,6.762262773722628,32.785,ducha
1559987841,1559988114,273,1.8964285714285716,2.935,lavamanos
1559989156,1559989291,135,1.4618181818181817,1.613,lavamanos
1559989906,1559989908,2,0.56,0.028,lavaplatos
1560007684,1560008870,1186,2.2512765957446805,6.4,lavaplatos
1560008019,1560008040,21,2.862,0.751,lavamanos
1560013321,1560013418,97,2.380434782608696,3.858,lavaplatos
1560013590,1560013634,44,1.48875,0.54,lavamanos
1560017594,1560018095,501,2.682857142857143,1.45,lavaplatos
1560018575,1560018620,45,1.059,0.425,lavamanos
1560022108,1560022124,16,0.576,0.081,lavaplatos
1560025858,1560026218,360,0.72,4.319999999999999,inodoro
1560027141,1560027182,41,1.136470588235294,0.397,lavamanos
1560057360,1560057396,36,0.3799999999999999,0.087,lavamanos
1560059863,1560059906,43,3.88578947368421,2.641,lavaplatos
1560062193,1560062553,360,0.72,4.319999999999999,inodoro
1560062571,1560062735,164,2.576697247706422,5.853,lavaplatos
1560065140,1560065441,301,2.172692307692308,2.094,lavamanos
1560068857,1560069616,759,2.566274509803921,7.206,lavaplatos
1560072743,1560072777,34,1.077,0.435,lavamanos
1560076598,1560076958,360,0.72,4.319999999999999,inodoro
1560077300,1560077887,587,2.2411764705882358,1.434,lavaplatos
1560089469,1560089516,47,1.1785714285714286,0.662,lavamanos
1560093500,1560094286,786,5.987303754266211,35.361,ducha
1560093612,1560094487,875,1.9575,6.5,lavamanos
1560094358,1560094718,360,0.72,4.319999999999999,inodoro
1560096163,1560096545,382,0.748,1.245,lavamanos
1560114665,1560114673,8,0.9525,0.149,lavamanos
1560116944,1560117304,360,0.72,4.319999999999999,inodoro
1560117987,1560118052,65,0.9709090909090908,0.308,lavaplatos
1560118486,1560118846,360,0.72,4.319999999999999,inodoro
1560119307,1560119347,40,2.033333333333333,0.633,lavamanos
1560145725,1560145729,4,0.948,0.079,lavamanos
1560146031,1560146391,360,0.72,4.319999999999999,inodoro
1560146309,1560147923,1614,2.7352941176470584,29.083,lavaplatos
1560148828,1560149694,866,6.9646788990825685,28.839,ducha
1560148865,1560149916,1051,2.9832203389830507,6.68,lavamanos
1560162806,1560162855,49,1.002352941176471,0.43,lavamanos
1560164659,1560166121,1462,2.024494382022472,13.349,lavaplatos
1560168992,1560169366,374,1.6510344827586207,3.158,lavamanos
1560169270,1560169733,463,0.6599999999999999,0.022,lavaplatos
1560169361,1560169721,360,0.72,4.319999999999999,inodoro
1560174902,1560174961,59,2.473125,1.458,lavamanos
1560176489,1560176849,360,0.72,4.319999999999999,inodoro
1560178805,1560178810,5,2.79,0.279,lavamanos
1560181545,1560181569,24,2.496521739130434,1.006,lavamanos
1560181868,1560182947,1079,1.0439999999999998,0.744,lavaplatos
1560187331,1560187837,506,2.095609756097561,7.374,lavamanos
1560187911,1560187931,20,1.08375,0.333,lavaplatos
1560192333,1560197757,5424,2.1747169811320752,54.359,lavaplatos
1560197037,1560197168,131,4.518461538461538,4.243,lavamanos
1560200082,1560204576,4494,2.6842105263157894,61.36,lavaplatos
1560201637,1560201670,33,0.9248275862068964,0.534,lavamanos
1560202379,1560202394,15,3.275,0.934,lavamanos
1560202799,1560203561,762,0.18,1.528,ducha
1560203557,1560203563,6,2.11,0.267,lavamanos
1560204641,1560205001,360,0.72,4.319999999999999,inodoro
1560208580,1560208590,10,0.51,0.152,ducha
1560208723,1560208753,30,5.422758620689655,2.827,lavamanos
1560230249,1560232236,1987,2.4817699115044247,34.549,lavaplatos
1560231364,1560231724,360,0.72,4.319999999999999,inodoro
1560231929,1560232758,829,1.046422018348624,3.503,lavamanos
1560232143,1560232328,185,6.600346820809248,20.317,ducha
1560233690,1560234362,672,0.9257142857142856,0.823,lavamanos
1560235007,1560235367,360,0.72,4.319999999999999,inodoro
1560241277,1560241336,59,3.04,0.787,lavamanos
1560241633,1560241643,10,0.1599999999999999,0.024,lavaplatos
1560242766,1560243126,360,0.72,4.319999999999999,inodoro
1560287951,1560288311,360,0.72,4.319999999999999,inodoro
1560288039,1560288048,9,1.98,0.237,lavaplatos
1560288323,1560288683,360,0.72,4.319999999999999,inodoro
1560289985,1560291126,1141,2.72625,3.093,lavaplatos
1560291005,1560291022,17,1.5247058823529411,0.463,lavamanos
1560317593,1560317953,360,0.72,4.319999999999999,inodoro
1560317723,1560318835,1112,2.4871875,9.325,lavaplatos
1560319533,1560319893,360,0.72,4.319999999999999,inodoro
1560322042,1560322692,650,3.021818181818182,24.176,lavaplatos
1560322863,1560322864,1,0.3299999999999999,0.011,lavamanos
1560329309,1560329357,48,1.4866666666666666,0.337,lavamanos
1560331284,1560331644,360,0.72,4.319999999999999,inodoro
1560332807,1560333621,814,4.940895522388059,25.282,ducha
1560332872,1560334092,1220,3.6485496183206094,8.946,lavamanos
1560338029,1560338047,18,2.7333333333333334,0.824,lavaplatos
1560341770,1560341841,71,2.024210526315789,0.887,lavamanos
1560343821,1560344933,1112,1.230967741935484,1.056,lavamanos
1560345163,1560345523,360,0.72,4.319999999999999,inodoro
1560346816,1560346892,76,3.4066666666666667,2.034,lavamanos
1560347893,1560347986,93,1.797391304347826,0.865,lavamanos
1560351165,1560351169,4,0.816,0.068,lavaplatos
1560351404,1560351566,162,6.010657894736842,16.189,ducha
1560352227,1560352996,769,1.0493877551020407,2.038,lavamanos
1560372222,1560372224,2,1.26,0.06,lavaplatos
1560373010,1560373023,13,0.9369230769230767,0.223,lavamanos
1560374224,1560374293,69,0.72,0.3,lavamanos
1560404832,1560405147,315,1.44,5.576,lavaplatos
1560405159,1560405162,3,0.4499999999999999,0.03,lavamanos
1560406121,1560406481,360,0.72,4.319999999999999,inodoro
1560406133,1560406379,246,6.081724137931034,24.878,ducha
1560406404,1560408188,1784,1.7035555555555555,8.747,lavamanos
1560408037,1560408397,360,0.72,4.319999999999999,inodoro
1560447130,1560447142,12,1.1018181818181818,0.226,lavamanos
1560447926,1560447930,4,1.46,0.077,lavaplatos
1560448123,1560448163,40,2.7484615384615383,1.801,lavamanos
1560449385,1560449447,62,1.41,0.567,lavamanos
1560451649,1560453113,1464,3.2610810810810813,5.711,lavaplatos
1560451774,1560452590,816,3.528,8.487,lavamanos
1560452378,1560452738,360,0.72,4.319999999999999,inodoro
1560452380,1560452740,360,0.72,4.319999999999999,inodoro
1560453276,1560453318,42,6.827999999999999,2.505,lavamanos
1560454786,1560455146,360,0.72,4.319999999999999,inodoro
1560454805,1560454819,14,4.494545454545454,0.838,lavamanos
1560461250,1560461274,24,3.1866666666666665,0.542,lavamanos
1560462223,1560462252,29,3.609230769230769,0.945,lavamanos
1560462240,1560463486,1246,1.9525,16.967,lavaplatos
1560464754,1560464849,95,4.030434782608696,6.049,lavamanos
1560465932,1560465987,55,2.64,0.629,lavamanos
1560466958,1560466992,34,2.1085714285714285,0.36,lavamanos
1560467032,1560469770,2738,2.6593478260869565,26.402,lavaplatos
1560468986,1560469346,360,0.72,4.319999999999999,inodoro
1560469035,1560469053,18,1.5759999999999998,0.437,lavamanos
1560470213,1560470225,12,0.65,0.141,lavamanos
1560491027,1560491825,798,1.281308411214953,4.054,lavaplatos
1560492449,1560492809,360,0.72,4.319999999999999,inodoro
1560492511,1560492871,360,0.72,4.319999999999999,inodoro
1560493570,1560494682,1112,5.369918699186991,93.568,ducha
1560493652,1560494750,1098,2.720909090909091,29.072,lavamanos
1560495886,1560495920,34,1.76625,1.008,lavamanos
1560516291,1560516304,13,4.03,0.839,lavaplatos
1560517882,1560517935,53,1.528235294117647,0.608,lavamanos
1560520189,1560520254,65,1.7452173913043476,0.979,lavamanos
1560521200,1560521252,52,2.367272727272727,0.932,lavamanos
1560536199,1560536313,114,2.2437735849056604,4.252,lavamanos
1560536208,1560536558,350,6.162310756972111,30.373,ducha
1560551600,1560551960,360,0.72,4.319999999999999,inodoro
1560552023,1560552042,19,1.6666666666666667,0.564,lavamanos
1560552251,1560552611,360,0.72,4.319999999999999,inodoro
1560565290,1560565771,481,1.1845714285714286,3.14,lavamanos
1560567733,1560567785,52,2.454545454545454,1.161,lavamanos
1560582543,1560583179,636,1.98,2.55,lavaplatos
1560583908,1560588617,4709,1.1897142857142855,10.503,ducha
1560584082,1560584603,521,2.6919786096256684,19.978,lavamanos
1560584456,1560584816,360,0.72,4.319999999999999,inodoro
1560587120,1560588686,1566,3.1484647302904563,81.739,lavamanos
1560590168,1560590260,92,1.6042105263157893,2.291,lavamanos
1560590537,1560590543,6,0.72,0.064,lavaplatos
1560592896,1560592902,6,1.9028571428571428,0.222,lavamanos
1560595717,1560595918,201,0.8266666666666667,0.983,lavaplatos
1560611879,1560612239,360,0.72,4.319999999999999,inodoro
1560612084,1560617177,5093,5.804459459459459,94.92,ducha
1560612144,1560612504,360,0.72,4.319999999999999,inodoro
1560613023,1560613142,119,4.827428571428571,6.542,lavamanos
1560614284,1560614291,7,1.425,0.103,lavaplatos
1560615577,1560615667,90,2.743448275862069,1.664,lavamanos
1560616117,1560616165,48,2.8223076923076924,1.942,lavaplatos
1560616430,1560617525,1095,2.181467889908257,4.231,lavamanos
1560619826,1560619859,33,0.648,0.181,lavamanos
1560636550,1560636568,18,2.5976470588235294,0.771,lavamanos
1560652315,1560652379,64,3.407692307692308,2.388,lavamanos
1560667554,1560667914,360,0.72,4.319999999999999,inodoro
1560670158,1560670164,6,2.41,0.295,lavaplatos
1560670964,1560671324,360,0.72,4.319999999999999,inodoro
1560674345,1560674360,15,0.96,0.246,lavamanos
1560674587,1560674901,314,2.393059701492537,12.62,lavaplatos
1560675516,1560675876,360,0.72,4.319999999999999,inodoro
1560675704,1560676064,360,0.72,4.319999999999999,inodoro
1560676480,1560676840,360,0.72,4.319999999999999,inodoro
1560678322,1560678682,360,0.72,4.319999999999999,inodoro
1560678554,1560678914,360,0.72,4.319999999999999,inodoro
1560679013,1560679373,360,0.72,4.319999999999999,inodoro
1560682574,1560682934,360,0.72,4.319999999999999,inodoro
1560682939,1560683299,360,0.72,4.319999999999999,inodoro
1560684411,1560685634,1223,2.797659574468085,4.64,lavaplatos
1560686702,1560686954,252,1.707272727272727,2.269,lavamanos
1560686889,1560687249,360,0.72,4.319999999999999,inodoro
1560694118,1560695531,1413,1.2807692307692309,2.558,lavaplatos
1560697392,1560697417,25,4.0008,1.736,lavaplatos
1560703491,1560704064,573,3.5525274725274727,40.27,ducha
1560703790,1560703861,71,1.1077611940298508,1.328,lavamanos
1560707639,1560707684,45,0.8192307692307692,0.696,lavamanos
1560708211,1560708571,360,0.72,4.319999999999999,inodoro
1560709486,1560709593,107,1.06,1.63,lavamanos
1560727712,1560727758,46,1.428,0.312,lavamanos
1560750505,1560751132,627,2.2161290322580647,26.409,lavaplatos
1560751085,1560751445,360,0.72,4.319999999999999,inodoro
1560751113,1560752046,933,1.8925714285714288,5.76,lavamanos
1560753259,1560753619,360,0.72,4.319999999999999,inodoro
1560753802,1560753840,38,1.3099999999999998,0.329,lavamanos
1560754006,1560754366,360,0.72,4.319999999999999,inodoro
1560796364,1560796442,78,1.8738461538461535,0.834,lavamanos
1560798571,1560798931,360,0.72,4.319999999999999,inodoro
1560799385,1560799466,81,0.5571428571428572,0.237,lavamanos
1560802244,1560802753,509,1.8377777777777775,1.074,lavamanos
1560802692,1560806140,3448,2.201941747572816,32.672,lavaplatos
1560806856,1560807781,925,0.7885714285714285,0.672,lavamanos
1560810008,1560810196,188,2.7237735849056603,2.873,lavamanos
1560836203,1560836217,14,1.7228571428571429,0.225,lavaplatos
1560836269,1560836629,360,0.72,4.319999999999999,inodoro
1560836384,1560839322,2938,2.8551724137931034,4.399,ducha
1560836584,1560836675,91,1.6472093023255814,2.505,lavamanos
1560837537,1560837567,30,1.134,0.589,lavamanos
1560837663,1560838023,360,0.72,4.319999999999999,inodoro
1560838411,1560839685,1274,1.2554716981132077,1.471,lavamanos
1560839538,1560839662,124,1.14,2.59,lavaplatos
1560847062,1560847204,142,1.854,0.942,lavamanos
1560847094,1560847893,799,0.24,4.796,ducha
1560847779,1560847804,25,4.52,1.962,lavaplatos
1560847856,1560848020,164,3.052941176470588,2.128,lavamanos
1560876532,1560876688,156,1.7583333333333333,1.571,lavamanos
1560888538,1560888623,85,1.7989655172413792,2.089,lavaplatos
1560890754,1560891431,677,1.2561290322580645,1.048,lavamanos
1560891525,1560891885,360,0.72,4.319999999999999,inodoro
1560891742,1560892102,360,0.72,4.319999999999999,inodoro
1560920957,1560921703,746,1.9965217391304344,15.854,lavaplatos
1560925349,1560925407,58,3.451111111111111,3.394,lavaplatos
1560925641,1560925702,61,1.6476923076923076,0.582,lavamanos
1560926791,1560926858,67,1.2646153846153845,0.415,lavamanos
1560927191,1560927551,360,0.72,4.319999999999999,inodoro
1560927922,1560928000,78,1.1857142857142855,0.549,lavamanos
1560929069,1560929133,64,1.5652173913043477,0.72,lavamanos
1560929932,1560929939,7,0.39,0.034,lavaplatos
1560932003,1560932071,68,0.8649999999999999,0.452,lavamanos
1560934458,1560934998,540,2.802385321100917,19.348,lavamanos
1560934620,1560934980,360,0.72,4.319999999999999,inodoro
1560934695,1560940142,5447,0.2759999999999999,0.517,ducha
1560936640,1560936745,105,1.7,0.88,lavamanos
1560939209,1560939836,627,2.228823529411765,18.664,lavaplatos
1560939904,1560939972,68,0.8918181818181817,0.434,lavamanos
1560942701,1560943075,374,1.738181818181818,10.45,lavamanos
1560943810,1560944063,253,1.9411111111111112,3.197,lavamanos
1560943962,1560945687,1725,2.5398,25.266,lavaplatos
1560945212,1560945796,584,1.2713513513513512,1.167,lavamanos
1560947122,1560947532,410,2.382,5.692,lavamanos
1560947182,1560947358,176,7.199999999999999,21.314,ducha
1560948652,1560948763,111,0.6888888888888889,0.757,lavamanos
1560978955,1560978963,8,1.0542857142857145,0.165,lavamanos
1560979709,1560979717,8,1.14,0.134,lavaplatos
1561006823,1561006981,158,1.4336842105263157,1.883,lavaplatos
1561008435,1561008445,10,0.6545454545454544,0.12,lavamanos
1561009459,1561009471,12,1.0107692307692309,0.219,lavamanos
1561011965,1561012052,87,2.058260869565217,0.957,lavamanos
1561012698,1561013434,736,1.4659459459459458,2.228,lavamanos
1561013072,1561015575,2503,3.765913043478261,8.413,ducha
1561014734,1561015364,630,0.7706666666666667,1.11,lavamanos
1561015262,1561015622,360,0.72,4.319999999999999,inodoro
1561096723,1561097081,358,1.5568421052631578,1.982,lavamanos
1561097685,1561100191,2506,2.8404545454545453,4.78,lavaplatos
1561102494,1561102527,33,1.74,0.413,lavamanos
1561102564,1561102624,60,2.281052631578947,2.319,lavaplatos
1561103731,1561104264,533,2.032,1.08,lavamanos
1561104992,1561105004,12,0.8799999999999999,0.196,lavamanos
1561106488,1561106517,29,2.04,0.962,lavamanos
1561106974,1561107359,385,2.0835,3.495,lavaplatos
1561108010,1561108028,18,1.8352941176470587,0.56,lavamanos
1561110992,1561111002,10,1.38,0.261,lavamanos
1561112674,1561112741,67,0.99,0.573,lavamanos
1561112763,1561113123,360,0.72,4.319999999999999,inodoro
1561114919,1561115279,360,0.72,4.319999999999999,inodoro
1561117284,1561117309,25,3.1157142857142857,0.753,lavaplatos
1561118175,1561118194,19,1.1737499999999998,0.353,lavamanos
1561119147,1561119507,360,0.72,4.319999999999999,inodoro
1561119224,1561119279,55,1.296923076923077,0.394,lavamanos
1561119360,1561120356,996,1.7680575539568346,11.842,lavaplatos
1561121299,1561121865,566,0.96375,0.37,lavamanos
1561124995,1561125006,11,0.7371428571428572,0.12,lavamanos
1561128931,1561130037,1106,1.22,0.937,lavaplatos
1561133589,1561133599,10,0.615,0.055,lavaplatos
1561133646,1561134091,445,1.3111475409836064,1.846,lavamanos
1561139062,1561139072,10,4.309090909090909,0.79,lavaplatos
1561139285,1561139368,83,0.9654545454545452,0.405,lavamanos
1561139819,1561140179,360,0.72,4.319999999999999,inodoro
1561144432,1561144938,506,2.0485714285714285,1.886,lavamanos
1561145322,1561145376,54,3.353076923076923,3.08,lavaplatos
1561147878,1561148120,242,2.816303317535545,11.433,ducha
1561147919,1561148139,220,2.4584615384615383,6.039,lavamanos
1561149711,1561150901,1190,0.84,0.965,lavamanos
1561172263,1561172326,63,1.9914285714285715,0.901,lavamanos
1561172509,1561172869,360,0.72,4.319999999999999,inodoro
1561185016,1561185025,9,1.1925,0.163,lavaplatos
1561185445,1561185921,476,1.1072727272727272,2.709,lavamanos
1561186489,1561186849,360,0.72,4.319999999999999,inodoro
1561197343,1561197383,40,1.2499999999999998,0.364,lavamanos
1561198543,1561198903,360,0.72,4.319999999999999,inodoro
1561205330,1561205334,4,2.235,0.151,lavaplatos
1561207578,1561208259,681,2.972054794520548,3.851,lavaplatos
1561207721,1561209143,1422,2.6426086956521737,8.024,lavamanos
1561208657,1561209017,360,0.72,4.319999999999999,inodoro
1561209132,1561209492,360,0.72,4.319999999999999,inodoro
1561211217,1561211559,342,3.211875,1.831,lavamanos
1561216535,1561216547,12,1.426153846153846,0.309,lavamanos
1561217280,1561217286,6,1.7639999999999998,0.155,lavamanos
1561218246,1561218424,178,2.161621621621621,2.248,lavamanos
1561218377,1561218737,360,0.72,4.319999999999999,inodoro
1561218382,1561218742,360,0.72,4.319999999999999,inodoro
1561218745,1561220551,1806,1.9766666666666663,6.951,lavaplatos
1561219709,1561219764,55,0.73875,0.29,lavamanos
1561221764,1561222124,360,0.72,4.319999999999999,inodoro
1561221944,1561222067,123,1.0485436893203883,1.95,lavamanos
1561222150,1561222284,134,5.07375,11.475,ducha
1561222956,1561223554,598,1.333548387096774,4.39,lavamanos
1561230508,1561230732,224,1.8377777777777775,3.935,lavamanos
1561235322,1561235354,32,0.6257142857142857,0.138,lavamanos
1561265822,1561265859,37,0.624,0.138,lavamanos
1561266035,1561266386,351,2.99625,6.799,lavaplatos
1561266666,1561266948,282,1.4809345794392523,3.179,lavamanos
1561268377,1561268737,360,0.72,4.319999999999999,inodoro
1561307349,1561307356,7,0.4028571428571428,0.056,lavamanos
1561313576,1561313590,14,1.8642857142857143,0.471,lavamanos
1561315203,1561315425,222,3.66378947368421,13.586,ducha
1561315209,1561315731,522,2.5555263157894736,3.651,lavamanos
1561331415,1561331488,73,0.7749999999999999,0.295,lavamanos
1561355741,1561356101,360,0.72,4.319999999999999,inodoro
1561355822,1561356102,280,1.8037795275590551,6.242,lavamanos
1561356255,1561356859,604,1.461176470588235,7.665,lavaplatos
1561356914,1561357274,360,0.72,4.319999999999999,inodoro
1561357145,1561357593,448,1.6271830985915492,5.946,lavamanos
1561357482,1561357651,169,4.33275,12.25,ducha
1561358532,1561358973,441,0.7176,0.515,lavamanos
1561359369,1561359431,62,0.4574999999999999,0.171,lavaplatos
1561359776,1561360136,360,0.72,4.319999999999999,inodoro
1561400261,1561401288,1027,1.4207407407407406,3.439,lavamanos
1561400295,1561400346,51,0.6950000000000001,0.593,lavaplatos
1561400839,1561401024,185,5.246742857142857,16.239,ducha
1561421478,1561421490,12,0.845,0.184,lavaplatos
1561421937,1561422689,752,2.116216216216216,3.616,lavamanos
1561422093,1561424363,2270,1.6,5.465,ducha
1561440052,1561440352,300,1.9418181818181817,2.53,lavaplatos
1561440151,1561440511,360,0.72,4.319999999999999,inodoro
1561440547,1561442354,1807,1.6055737704918032,6.507,lavamanos
1561440728,1561442327,1599,4.831624548736461,26.385,ducha
1561441603,1561441963,360,0.72,4.319999999999999,inodoro
1561452961,1561452999,38,1.308,0.415,lavamanos
1561453172,1561453373,201,0.24,1.208,ducha
1561458825,1561458839,14,0.9709090909090908,0.186,lavamanos
1561472728,1561472939,211,2.4365482233502536,8.578,ducha
1561473815,1561473899,84,2.8422857142857145,2.234,lavamanos
1561477022,1561477078,56,2.6538461538461537,0.665,lavamanos
1561479082,1561479094,12,0.985,0.21,lavamanos
1561479375,1561479969,594,1.6254545454545453,0.324,lavaplatos
1561482491,1561482522,31,1.77375,0.561,lavaplatos
1561483018,1561483179,161,4.078013245033112,10.909,ducha
1561483020,1561483097,77,3.28027397260274,4.277,lavamanos
1561483675,1561484035,360,0.72,4.319999999999999,inodoro
1561484071,1561484153,82,0.756774193548387,0.546,lavamanos
1561500865,1561500920,55,0.816,0.299,lavamanos
1561501218,1561501373,155,1.6126315789473684,3.111,lavaplatos
1561503259,1561503371,112,1.876363636363636,1.955,lavamanos
1561529646,1561530006,360,0.72,4.319999999999999,inodoro
1561529680,1561529761,81,1.3125,0.323,lavamanos
1561530193,1561531001,808,2.022413793103448,2.376,lavaplatos
1561530214,1561530574,360,0.72,4.319999999999999,inodoro
1561531135,1561531495,360,0.72,4.319999999999999,inodoro
1561531162,1561531305,143,3.3081818181818177,1.524,lavamanos
1561533839,1561534138,299,0.8652631578947367,0.781,lavamanos
1561535984,1561536015,31,1.14,0.537,lavaplatos
1561536223,1561536346,123,0.84,0.872,lavamanos
1561536347,1561539134,2787,0.495,0.117,ducha
1561537243,1561537603,360,0.72,4.319999999999999,inodoro
1561537940,1561539153,1213,0.6066666666666666,0.103,lavaplatos
1561539123,1561539123,1,1.44,0.024,lavamanos
1561539790,1561539878,88,1.0626666666666666,0.954,lavamanos
1561543519,1561543533,14,0.916,0.229,lavamanos
1561544370,1561544730,360,0.72,4.319999999999999,inodoro
1561545017,1561545109,92,0.738,0.586,lavamanos
1561545413,1561545950,537,3.3341176470588234,30.321,lavaplatos
1561546282,1561546642,360,0.72,4.319999999999999,inodoro
1561546625,1561546628,3,0.54,0.036,lavamanos
1561547929,1561550545,2616,2.345,44.982,lavaplatos
1561548602,1561548682,80,0.6074999999999999,0.227,lavamanos
1561550328,1561550688,360,0.72,4.319999999999999,inodoro
1561550991,1561551230,239,2.570322580645161,2.801,lavamanos
1561552139,1561552211,72,1.515,0.826,lavamanos
1561552819,1561552827,8,0.645,0.062,lavaplatos
1561592200,1561592462,262,0.89,2.696,lavamanos
1561599830,1561600310,480,0.3199999999999999,0.016,lavamanos
1561614121,1561614130,9,2.36,0.356,lavaplatos
1561614852,1561615013,161,6.5201324503311255,17.45,ducha
1561615197,1561615475,278,1.581,0.687,lavamanos
1561616446,1561616806,360,0.72,4.319999999999999,inodoro
1561617051,1561617055,4,0.852,0.071,lavamanos
1561617817,1561617836,19,4.611999999999999,1.246,lavaplatos
1561617927,1561617942,15,0.8119999999999999,0.218,lavamanos
1561624526,1561624886,360,0.72,4.319999999999999,inodoro
1561794240,1561794245,5,0.7599999999999999,0.076,lavamanos
1561794371,1561794395,24,2.5513043478260866,1.027,lavaplatos
1561795836,1561796196,360,0.72,4.319999999999999,inodoro
1561797110,1561798301,1191,1.776867469879518,28.205,lavaplatos
1561799207,1561799243,36,0.7469999999999999,0.296,lavamanos
1561802939,1561803299,360,0.72,4.319999999999999,inodoro
1561804773,1561804774,1,1.59,0.053,lavaplatos
1561808958,1561809644,686,0.9913043478260868,6.47,lavaplatos
1561816193,1561816553,360,0.72,4.319999999999999,inodoro
1561818151,1561818511,360,0.72,4.319999999999999,inodoro
1561826486,1561826536,50,1.36,0.666,lavaplatos
1561832503,1561832542,39,0.78,0.397,lavamanos
1561832620,1561832980,360,0.72,4.319999999999999,inodoro
1561839608,1561839968,360,0.72,4.319999999999999,inodoro
1561848190,1561848197,7,0.8999999999999999,0.12,lavamanos
1561880233,1561881103,870,3.2270526315789474,11.784,lavaplatos
1561882071,1561882357,286,1.1696,3.186,lavamanos
1561882423,1561882783,360,0.72,4.319999999999999,inodoro
1561882800,1561883160,360,0.72,4.319999999999999,inodoro
1561883123,1561883483,360,0.72,4.319999999999999,inodoro
1561883126,1561883143,17,2.1988235294117646,0.67,lavamanos
1561883408,1561883544,136,2.526,2.515,lavaplatos
1561885283,1561885365,82,1.4925,0.744,lavamanos
1561890433,1561890487,54,1.0363636363636364,0.746,lavaplatos
1561901076,1561901182,106,1.769142857142857,1.294,lavamanos
1561904886,1561904890,4,2.928,0.244,lavaplatos
1561904933,1561904998,65,1.5784615384615384,0.484,lavamanos
1561906715,1561906760,45,0.6857142857142857,0.158,lavamanos
1561917245,1561917605,360,0.72,4.319999999999999,inodoro
1561919734,1561919746,12,0.845,0.184,lavamanos
1561922932,1561923151,219,5.361739130434782,19.753,ducha
1561922974,1561924176,1202,2.7387341772151896,5.243,lavamanos
1561933425,1561933924,499,2.401935483870968,6.434,lavamanos
1561933936,1561934296,360,0.72,4.319999999999999,inodoro
1561935021,1561935045,24,1.1125,0.465,lavamanos
1561935389,1561937762,2373,0.3,4.233,ducha
1561962669,1561962914,245,2.3634782608695653,4.456,lavamanos
1561962834,1561962987,153,5.258896551724138,13.465,ducha
1561963837,1561964400,563,0.834,0.5,lavamanos
1561964077,1561964437,360,0.72,4.319999999999999,inodoro
1561965152,1561965329,177,2.88,2.884,lavamanos
1562092012,1562092074,62,1.606153846153846,0.448,lavamanos
1562092140,1562093389,1249,2.795106382978723,5.522,lavaplatos
1562092676,1562092687,11,1.296,0.22,lavamanos
1562093621,1562093678,57,1.6430769230769229,0.896,lavamanos
1562095744,1562095757,13,1.3854545454545453,0.26,lavaplatos
1562096998,1562097014,16,0.896,0.246,lavamanos
1562098802,1562098805,3,0.75,0.05,lavaplatos
1562102026,1562102041,15,0.9771428571428572,0.25,lavamanos
1562132999,1562133002,3,2.31,0.154,lavaplatos
1562134932,1562135496,564,1.8514285714285716,1.729,lavamanos
1562135360,1562137275,1915,1.7482191780821916,2.561,lavaplatos
1562135591,1562135951,360,0.72,4.319999999999999,inodoro
1562135803,1562136163,360,0.72,4.319999999999999,inodoro
1562136074,1562136434,360,0.72,4.319999999999999,inodoro
1562140330,1562140870,540,5.814989816700611,52.535,ducha
1562140398,1562140544,146,3.319285714285714,1.908,lavamanos
1562141148,1562141878,730,0.8724999999999999,0.452,lavamanos
1562143279,1562143639,360,0.72,4.319999999999999,inodoro
1562150346,1562150391,45,0.8294117647058824,0.322,lavamanos
1562150765,1562152267,1502,1.8198648648648648,14.606,lavaplatos
1562160667,1562160680,13,1.11,0.16,lavaplatos
1562161037,1562161084,47,1.5252631578947369,0.572,lavamanos
1562161132,1562161492,360,0.72,4.319999999999999,inodoro
1562162888,1562162894,6,3.28,0.393,lavaplatos
1562165882,1562165891,9,0.8999999999999999,0.085,lavaplatos
1562167983,1562168343,360,0.72,4.319999999999999,inodoro
1562169516,1562170427,911,2.803076923076923,17.324,lavaplatos
1562170834,1562170922,88,1.6846153846153846,1.627,lavamanos
1562180515,1562180593,78,1.383529411764706,0.545,lavamanos
1562180770,1562181130,360,0.72,4.319999999999999,inodoro
1562180880,1562181240,360,0.72,4.319999999999999,inodoro
1562183271,1562183284,13,2.845,0.629,lavaplatos
1562183375,1562183442,67,1.5461538461538462,0.499,lavamanos
1562191850,1562191906,56,1.344705882352941,0.541,lavamanos
1562193019,1562193681,662,1.0075,1.745,lavamanos
1562217802,1562217811,9,0.93,0.074,lavaplatos
1562218157,1562218931,774,1.223181818181818,1.931,lavamanos
1562218311,1562219686,1375,3.620084745762712,19.198,ducha
1562219587,1562219947,360,0.72,4.319999999999999,inodoro
1562219615,1562221355,1740,1.5085714285714285,0.401,lavaplatos
1562219824,1562220758,934,0.9888,2.428,lavamanos
1562221566,1562221926,360,0.72,4.319999999999999,inodoro
1562261231,1562262541,1310,2.2577142857142856,2.542,lavaplatos
1562266723,1562267150,427,1.768695652173913,0.718,lavamanos
1562268162,1562268195,33,0.4049999999999999,0.106,lavamanos
1562268534,1562268580,46,3.259285714285714,1.941,lavaplatos
1562269796,1562270156,360,0.72,4.319999999999999,inodoro
1562306655,1562306867,212,1.58625,8.908,lavaplatos
1562308174,1562308534,360,0.72,4.319999999999999,inodoro
1562309700,1562310590,890,1.0894736842105264,5.926,lavamanos
1562339279,1562339639,360,0.72,4.319999999999999,inodoro
1562358538,1562358898,360,0.72,4.319999999999999,inodoro
1562358586,1562358602,16,0.375,0.103,lavamanos
1562395502,1562395862,360,0.72,4.319999999999999,inodoro
1562396119,1562396479,360,0.72,4.319999999999999,inodoro
1562396447,1562396609,162,1.51,2.928,lavaplatos
1562396794,1562396849,55,0.12,0.112,lavamanos
1562400319,1562400321,2,1.2799999999999998,0.064,lavaplatos
1562400475,1562400489,14,0.8228571428571427,0.207,lavamanos
1562400678,1562401038,360,0.72,4.319999999999999,inodoro
1562403324,1562403331,7,0.84,0.1,lavamanos
1562406239,1562406273,34,1.46,0.283,lavamanos
1562406871,1562407033,162,1.5174193548387096,2.243,lavaplatos
1562408079,1562408439,360,0.72,4.319999999999999,inodoro
1562410515,1562410555,40,1.5719999999999998,0.476,lavamanos
1562413456,1562413516,60,2.664705882352941,0.904,lavamanos
1562414643,1562414831,188,4.729887640449438,14.953,ducha
1562424975,1562424977,2,0.84,0.042,lavaplatos
1562425013,1562425373,360,0.72,4.319999999999999,inodoro
1562427262,1562427290,28,1.44,2.292,lavamanos
1562427844,1562427892,48,1.9107692307692308,1.694,lavaplatos
1562433296,1562434318,1022,2.0,0.54,lavaplatos
1562434461,1562434821,360,0.72,4.319999999999999,inodoro
1562435877,1562436007,130,1.0564285714285715,1.148,lavamanos
1562436554,1562436571,17,1.6411764705882352,0.471,lavaplatos
1562436650,1562436664,14,0.7885714285714285,0.197,lavamanos
1562439091,1562439102,11,1.8654545454545453,0.378,lavamanos
1562439419,1562443026,3607,2.280621761658031,14.0,lavaplatos
1562439823,1562439939,116,5.449999999999999,6.193,lavamanos
1562441079,1562441079,1,0.36,0.006,lavamanos
1562442676,1562442984,308,5.114338235294118,26.448,ducha
1562442927,1562443290,363,2.638153846153846,3.109,lavamanos
1562448787,1562449560,773,0.774,0.588,lavamanos
1562449154,1562449306,152,6.02,15.321,ducha
1562449568,1562449928,360,0.72,4.319999999999999,inodoro
1562467222,1562467582,360,0.72,4.319999999999999,inodoro
1562467593,1562467633,40,2.0342857142857143,0.795,lavamanos
1562485873,1562486233,360,0.72,4.319999999999999,inodoro
1562486301,1562487673,1372,1.835,0.375,lavaplatos
1562492248,1562492608,360,0.72,4.319999999999999,inodoro
1562496202,1562499035,2833,1.7331818181818182,7.397,lavaplatos
1562497304,1562497664,360,0.72,4.319999999999999,inodoro
1562501342,1562504164,2822,2.515384615384615,8.408,lavaplatos
1562504590,1562504950,360,0.72,4.319999999999999,inodoro
1562505189,1562505191,2,0.56,0.028,lavamanos
1562505309,1562505669,360,0.72,4.319999999999999,inodoro
1562510324,1562510399,75,3.963333333333333,5.054,ducha
1562510623,1562510635,12,1.189090909090909,0.24,lavamanos
1562513308,1562513341,33,3.32,0.598,lavamanos
1562516799,1562518315,1516,2.043809523809524,19.354,lavaplatos
1562518794,1562519121,327,2.796705882352941,5.451,lavamanos
1562520146,1562522478,2332,1.6032558139534885,24.962,lavaplatos
1562523170,1562523530,360,0.72,4.319999999999999,inodoro
1562526011,1562526042,31,0.7333333333333333,0.172,lavamanos
1562530818,1562530839,21,0.8171428571428571,0.299,lavamanos
1562565679,1562566775,1096,2.611428571428572,15.016,lavaplatos
1562567265,1562567688,423,6.025263157894736,42.447,ducha
1562567309,1562567586,277,3.076,3.403,lavamanos
1562568250,1562568263,13,1.015,0.225,lavamanos
1562569157,1562569657,500,0.8921739130434783,0.504,lavamanos
1562569805,1562570165,360,0.72,4.319999999999999,inodoro
1562603598,1562603688,90,2.7675,6.255,lavaplatos
1562605947,1562606307,360,0.72,4.319999999999999,inodoro
1562606592,1562606600,8,0.765,0.106,lavamanos
1562607511,1562607619,108,3.5137864077669905,6.469,ducha
1562607553,1562607553,1,0.36,0.006,lavamanos
1562607864,1562608224,360,0.72,4.319999999999999,inodoro
1562610132,1562610547,415,3.4153333333333333,5.487,lavamanos
1562617452,1562617488,36,1.5759999999999998,0.467,lavamanos
1562618147,1562618507,360,0.72,4.319999999999999,inodoro
1562618248,1562618254,6,0.71,0.073,lavamanos
1562654072,1562654085,13,1.656,0.156,lavaplatos
1562661906,1562661918,12,1.825,0.407,lavaplatos
1562671261,1562671621,360,0.72,4.319999999999999,inodoro
1562673353,1562673371,18,2.09,0.432,lavaplatos
1562676418,1562676964,546,2.148,7.144,lavamanos
1562676972,1562677791,819,3.716037735849056,10.241,ducha
1562677835,1562678239,404,1.5234782608695652,0.732,lavamanos
1562708989,1562709026,37,0.9109090909090908,0.241,lavamanos
1562712360,1562719095,6735,0.12,2.076,ducha
1562725561,1562728380,2819,0.285,3.851,ducha
1562735270,1562735441,171,1.46,4.743,lavaplatos
1562738561,1562738921,360,0.72,4.319999999999999,inodoro
1562739363,1562741000,1637,0.8181818181818181,1.847,lavamanos
1562739428,1562739788,360,0.72,4.319999999999999,inodoro
1562739635,1562739867,232,5.876164383561644,22.781,ducha
1562762863,1562762909,46,3.469090909090909,0.787,lavamanos
1562762932,1562766661,3729,3.675145631067961,8.984,lavaplatos
1562767261,1562767398,137,2.25,2.916,lavamanos
1562769233,1562772101,2868,2.190828729281768,55.485,lavaplatos
1562772549,1562772742,193,2.0554838709677417,5.934,lavamanos
1562773975,1562775157,1182,2.387837837837838,6.622,lavaplatos
1562774305,1562774696,391,1.6307692307692307,1.239,lavamanos
1562775463,1562775515,52,1.4342857142857142,0.595,lavamanos
1562778689,1562779049,360,0.72,4.319999999999999,inodoro
1562780307,1562780703,396,1.302857142857143,2.703,lavamanos
1562780646,1562780779,133,5.35344,11.843,ducha
1562783160,1562783193,33,0.765,0.206,lavamanos
1562783369,1562784289,920,1.6075862068965516,3.242,lavaplatos
1562786370,1562792365,5995,3.2148051948051948,26.641,lavaplatos
1562787204,1562787204,1,3.78,0.063,lavamanos
1562787204,1562789651,2447,11.37,0.379,ducha
1562789651,1562789651,1,19.26,0.321,lavamanos
1562793725,1562794085,360,0.72,4.319999999999999,inodoro
1562795454,1562795776,322,1.8059016393442624,7.063,lavaplatos
1562795622,1562795642,20,4.877142857142857,1.152,lavamanos
1562796993,1562797001,8,0.99,0.134,lavamanos
1562798778,1562798791,13,3.83,0.77,lavamanos
1562801170,1562805303,4133,3.1278916827853,62.831,lavaplatos
1562804478,1562804838,360,0.72,4.319999999999999,inodoro
1562805596,1562805822,226,1.017391304347826,0.448,lavamanos
1562825123,1562827510,2387,1.440909090909091,3.839,lavamanos
1562827828,1562828188,360,0.72,4.319999999999999,inodoro
1562828157,1562828303,146,1.12125,2.207,lavaplatos
1562874481,1562874831,350,0.96,0.669,lavamanos
1562874523,1562874940,417,1.3282758620689654,7.569,lavaplatos
1562876561,1562877024,463,1.1921739130434783,0.612,lavamanos
1562891053,1562891053,1,0.36,0.006,lavamanos
1562899079,1562899390,311,2.217196261682243,7.814,lavamanos
1562899496,1562902737,3241,0.1714285714285714,4.21,ducha
1562901447,1562902737,1290,4.010649350649351,6.493,lavamanos
1562914785,1562914797,12,1.6849999999999998,0.339,lavaplatos
1562914817,1562915412,595,1.1320481927710844,1.712,lavamanos
1562915545,1562915877,332,4.204012738853503,23.327,ducha
1562917364,1562917819,455,1.0305882352941176,1.375,lavamanos
1562917881,1562918241,360,0.72,4.319999999999999,inodoro
1562927398,1562927404,6,0.8999999999999999,0.092,lavamanos
1562927756,1562927758,2,0.78,0.039,lavaplatos
1562928566,1562928835,269,1.8046153846153845,8.126,lavamanos
1562946422,1562946432,10,1.566,0.294,lavamanos
1562950013,1562950020,7,5.43,0.724,lavaplatos
1562951652,1562951691,39,0.96,0.294,lavamanos
1562953978,1562955134,1156,2.6557894736842105,21.895,lavaplatos
1562957757,1562958334,577,1.3552,3.732,lavamanos
1562960671,1562961031,360,0.72,4.319999999999999,inodoro
1562960719,1562960779,60,2.26,1.755,lavamanos
1562960771,1562960920,149,5.362127659574467,13.366,ducha
1562961626,1562961967,341,0.6626086956521738,1.026,lavamanos
1562962204,1562962564,360,0.72,4.319999999999999,inodoro
1562962272,1562962632,360,0.72,4.319999999999999,inodoro
1562973869,1562973890,21,0.8652631578947367,0.306,lavamanos
1563004640,1563004663,23,2.28,0.3,lavaplatos
1563010029,1563011528,1499,2.220701754385965,12.305,lavamanos
1563013588,1563013589,1,0.6,0.02,lavamanos
1563014758,1563014934,176,1.223076923076923,1.237,lavaplatos
1563050776,1563051136,360,0.72,4.319999999999999,inodoro
1563065661,1563065848,187,3.683050847457627,11.536,ducha
1563066005,1563066076,71,1.7968421052631578,1.572,lavamanos
1563072171,1563072175,4,0.816,0.068,lavamanos
1563092797,1563092864,67,2.695238095238095,3.018,lavamanos
1563094757,1563094832,75,2.8491891891891887,2.095,lavamanos
1563098813,1563099065,252,1.443,0.718,lavamanos
1563099060,1563099236,176,1.4466666666666663,0.85,lavaplatos
1563101128,1563101488,360,0.72,4.319999999999999,inodoro
1563102206,1563104068,1862,1.827391304347826,5.391,lavaplatos
1563104613,1563104973,360,0.72,4.319999999999999,inodoro
1563109486,1563109846,360,0.72,4.319999999999999,inodoro
1563109582,1563115455,5873,2.311319648093842,60.237,lavaplatos
1563115721,1563115738,17,0.963529411764706,0.291,lavamanos
1563118609,1563118616,7,0.63,0.084,lavamanos
1563119323,1563119683,360,0.72,4.319999999999999,inodoro
1563121136,1563121251,115,2.568,2.457,lavamanos
1563129915,1563130986,1071,5.156750000000001,66.505,ducha
1563129943,1563130006,63,2.4709090909090907,1.942,lavamanos
1563130737,1563130975,238,0.9266666666666666,1.337,lavamanos
1563131638,1563131890,252,1.3044444444444443,0.773,lavamanos
1563132641,1563132655,14,0.9323076923076924,0.219,lavamanos
1563133010,1563134121,1111,2.3194082840236687,9.8,lavaplatos
1563133693,1563134245,552,3.5565,2.631,lavamanos
1563146673,1563147764,1091,3.8105454545454553,40.125,lavaplatos
1563148895,1563149716,821,0.9163636363636364,2.714,lavamanos
1563169536,1563169543,7,0.8571428571428572,0.104,lavamanos
1563175373,1563175403,30,1.368,0.272,lavaplatos
1563175748,1563175938,190,1.6701030927835052,5.263,lavamanos
1563176590,1563176975,385,1.2518181818181815,0.578,lavamanos
1563177124,1563177484,360,0.72,4.319999999999999,inodoro
1563179086,1563179124,38,0.96,0.245,lavamanos
1563210805,1563211165,360,0.72,4.319999999999999,inodoro
1563211529,1563211889,360,0.72,4.319999999999999,inodoro
1563214467,1563214827,360,0.72,4.319999999999999,inodoro
1563222799,1563223159,360,0.72,4.319999999999999,inodoro
1563257508,1563257868,360,0.72,4.319999999999999,inodoro
1563262458,1563262818,360,0.72,4.319999999999999,inodoro
1563264886,1563265246,360,0.72,4.319999999999999,inodoro
1563269978,1563269981,3,0.6599999999999999,0.044,lavamanos
1563269993,1563269999,6,0.84,0.054,lavaplatos
1563270009,1563270369,360,0.72,4.319999999999999,inodoro
1563275498,1563277045,1547,1.872923076923077,7.459,lavaplatos
1563275635,1563275665,30,0.6399999999999999,0.114,lavamanos
1563276308,1563276358,50,2.927142857142857,1.037,lavamanos
1563276487,1563276847,360,0.72,4.319999999999999,inodoro
1563277069,1563277429,360,0.72,4.319999999999999,inodoro
1563277729,1563277742,13,1.48,0.356,lavamanos
1563280055,1563280094,39,1.1133333333333333,0.345,lavamanos
1563281034,1563281076,42,1.23,0.308,lavamanos
1563281078,1563281798,720,1.6427027027027026,1.29,lavaplatos
1563286519,1563287077,558,1.5278947368421052,3.266,lavamanos
1563291696,1563292244,548,0.96,0.176,lavamanos
1563294472,1563295048,576,2.571875,4.347,lavamanos
1563294680,1563295040,360,0.72,4.319999999999999,inodoro
1563298749,1563298835,86,0.7875,0.365,lavamanos
1563300249,1563300255,6,2.22,0.259,lavaplatos
1563301711,1563302006,295,5.027380952380953,23.851,ducha
1563301811,1563301864,53,4.191428571428571,2.636,lavamanos
1563302601,1563302607,6,1.4,0.142,lavamanos
1563314502,1563314862,360,0.72,4.319999999999999,inodoro
1563316256,1563316948,692,0.9019354838709678,0.503,lavamanos
1563343415,1563344071,656,1.9166666666666663,0.869,lavaplatos
1563344288,1563344307,19,0.8717647058823529,0.271,lavamanos
1563344956,1563345362,406,0.8450847457627119,1.998,lavamanos
1563346830,1563347144,314,1.2046153846153846,0.407,lavamanos
1563347305,1563347310,5,0.12,0.012,lavaplatos
1563385009,1563385119,110,1.8066666666666664,1.301,lavamanos
1563385651,1563385751,100,4.347157894736841,7.293,ducha
1563406940,1563407206,266,0.8474999999999999,0.239,lavamanos
1563425115,1563425118,3,0.375,0.025,lavamanos
1563428830,1563429838,1008,1.8793548387096772,2.861,lavaplatos
1563428853,1563428871,18,0.6599999999999999,0.065,lavamanos
1563430201,1563430217,16,0.8325,0.224,lavamanos
1563432143,1563432185,42,1.4625,0.477,lavamanos
1563433415,1563433815,400,0.8657142857142857,0.215,lavamanos
1563433987,1563434852,865,1.182,5.736,lavaplatos
1563436201,1563436561,360,0.72,4.319999999999999,inodoro
1563436958,1563437007,49,1.1863636363636365,0.511,lavamanos
1563439371,1563441988,2617,1.237741935483871,3.922,lavaplatos
1563440501,1563440520,19,0.6966666666666667,0.229,lavamanos
1563443907,1563444707,800,2.05,6.953,lavaplatos
1563448190,1563448201,11,2.4709090909090907,0.504,lavaplatos
1563448696,1563448960,264,1.0458227848101265,2.445,lavamanos
1563449628,1563449732,104,1.0753846153846154,0.788,lavamanos
1563474613,1563474623,10,1.0575,0.147,lavaplatos
1563474838,1563474935,97,1.08,1.365,lavamanos
1563474947,1563475023,76,4.538571428571428,5.802,ducha
1563520113,1563520473,360,0.72,4.319999999999999,inodoro
1563564412,1563564413,1,0.39,0.013,lavamanos
1563564475,1563569826,5351,1.783117870722433,30.959,lavaplatos
1563564486,1563564846,360,0.72,4.319999999999999,inodoro
1563570570,1563570586,16,0.892,0.243,lavamanos
1563603211,1563603239,28,1.6694117647058824,0.661,lavaplatos
1563606504,1563606864,360,0.72,4.319999999999999,inodoro
1563621336,1563621404,68,1.2742857142857142,2.332,lavaplatos
1563635860,1563636220,360,0.72,4.319999999999999,inodoro
1563636423,1563636783,360,0.72,4.319999999999999,inodoro
1563639111,1563639576,465,1.806315789473684,3.873,lavaplatos
1563665449,1563665809,360,0.72,4.319999999999999,inodoro
1563689482,1563689842,360,0.72,4.319999999999999,inodoro
1563691839,1563692199,360,0.72,4.319999999999999,inodoro
1563722452,1563722455,3,0.72,0.028,lavaplatos
1563722495,1563725422,2927,3.805839416058394,11.816,ducha
1563722546,1563722906,360,0.72,4.319999999999999,inodoro
1563722570,1563722570,1,0.8999999999999999,0.015,lavamanos
1563725369,1563726010,641,0.7114285714285714,1.352,lavamanos
1563728630,1563728644,14,0.9685714285714284,0.246,lavamanos
1563728798,1563728888,90,0.9141176470588236,1.304,lavaplatos
1563753128,1563753470,342,2.3078048780487803,6.915,lavamanos
1563753308,1563753880,572,0.3299999999999999,1.153,ducha
1563758652,1563760811,2159,0.144,3.844,ducha
1563764651,1563770830,6179,0.2279999999999999,5.768,ducha
1563774550,1563777790,3240,0.2,1.446,ducha
1563776614,1563776974,360,0.72,4.319999999999999,inodoro
1563779010,1563779026,16,1.6849999999999998,0.387,lavaplatos
1563779575,1563779695,120,1.1383783783783783,1.622,lavamanos
1563781490,1563781589,99,0.9085714285714284,1.175,lavamanos
1563783116,1563784481,1365,1.8075,0.921,lavaplatos
1563783343,1563783752,409,1.1274418604651164,5.554,lavamanos
1563820663,1563820689,26,1.3019999999999998,0.251,lavaplatos
1563824516,1563824567,51,1.0399999999999998,0.308,lavamanos
1563825817,1563826177,360,0.72,4.319999999999999,inodoro
1563825821,1563827732,1911,3.934791666666667,19.98,ducha
1563826088,1563826100,12,2.91,0.658,lavamanos
1563827538,1563827991,453,0.876,0.549,lavamanos
1563828222,1563828399,177,1.53,2.143,lavaplatos
1563832977,1563833622,645,2.2,0.466,lavaplatos
1563833675,1563834239,564,1.0645945945945945,1.795,lavamanos
1563834191,1563834551,360,0.72,4.319999999999999,inodoro
1563862232,1563862257,25,2.1085714285714285,0.284,lavaplatos
1563863153,1563863513,360,0.72,4.319999999999999,inodoro
1563863167,1563863507,340,4.043887147335424,22.899,ducha
1563863409,1563864963,1554,1.5729896907216494,3.835,lavamanos
1563866436,1563866466,30,0.92,0.102,lavamanos
1563868146,1563868177,31,1.305,0.143,lavamanos
1563868820,1563868826,6,2.142857142857143,0.25,lavamanos
1563870511,1563872342,1831,2.208,9.419,lavaplatos
1563873392,1563873511,119,1.8514285714285716,2.807,lavamanos
1563873843,1563874203,360,0.72,4.319999999999999,inodoro
1563976395,1563976402,7,0.7424999999999999,0.099,lavamanos
1563976743,1563976749,6,2.974285714285714,0.347,lavaplatos
1563978043,1563978084,41,0.86,0.158,lavamanos
1563980361,1563980721,360,0.72,4.319999999999999,inodoro
1563982787,1563984067,1280,2.610625,14.673,lavaplatos
1563984549,1563984766,217,1.7165853658536585,2.873,lavamanos
1563994957,1563995026,69,1.54125,0.981,lavaplatos
1563995336,1563995516,180,3.430235294117647,10.345,ducha
1563995344,1563995395,51,3.406875,1.985,lavamanos
1563996756,1563996894,138,0.765,1.012,lavamanos
1564013877,1564013911,34,0.84,0.387,lavamanos
1564015214,1564015574,360,0.72,4.319999999999999,inodoro
1564015443,1564015514,71,2.604,3.118,ducha
1564021120,1564025439,4319,0.192,7.244,ducha
1564034379,1564034388,9,1.17,0.087,lavamanos
1564034518,1564034526,8,0.18,0.026,lavaplatos
1564034916,1564035276,360,0.72,4.319999999999999,inodoro
1564035297,1564035734,437,0.9082758620689656,1.516,lavamanos
1564035749,1564035867,118,4.600540540540541,9.88,ducha
1564036464,1564036773,309,0.7599999999999999,0.038,lavamanos
1564079577,1564079937,360,0.72,4.319999999999999,inodoro
1564122562,1564122922,360,0.72,4.319999999999999,inodoro
1564123033,1564123039,6,0.2759999999999999,0.027,lavaplatos
1564123065,1564123065,1,0.54,0.009,lavamanos
1564123072,1564124612,1540,3.67875,6.909,ducha
1564124358,1564125735,1377,1.8069230769230769,4.066,lavamanos
1564142160,1564142165,5,1.332,0.113,lavaplatos
1564169988,1564170024,36,1.692,0.336,lavamanos
1564170017,1564170036,19,1.9275,0.406,lavaplatos
1564172352,1564172604,252,4.306285714285714,2.714,lavamanos
1564209616,1564210858,1242,2.2379999999999995,10.561,lavaplatos
1564210635,1564210995,360,0.72,4.319999999999999,inodoro
1564211293,1564211653,360,0.72,4.319999999999999,inodoro
1564211865,1564212225,360,0.72,4.319999999999999,inodoro
1564211925,1564212228,303,2.787857142857143,4.134,lavamanos
1564213073,1564213079,6,1.3885714285714286,0.162,lavamanos
1564213459,1564213819,360,0.72,4.319999999999999,inodoro
1564223648,1564224008,360,0.72,4.319999999999999,inodoro
1564227762,1564227771,9,0.7933333333333332,0.121,lavamanos
1564229989,1564229992,3,0.975,0.065,lavaplatos
1564232319,1564232324,5,1.056,0.103,lavamanos
1564234475,1564234835,360,0.72,4.319999999999999,inodoro
1564236080,1564236122,42,1.75125,0.559,lavamanos
1564242620,1564242980,360,0.72,4.319999999999999,inodoro
1564245154,1564245357,203,1.8476190476190475,3.115,lavamanos
1564246253,1564246263,10,1.0363636363636364,0.19,lavamanos
1564265541,1564265588,47,1.64625,0.537,lavamanos
1564294969,1564294976,7,2.777142857142857,0.326,lavaplatos
1564298209,1564298569,360,0.72,4.319999999999999,inodoro
1564303664,1564304277,613,2.2032,1.033,lavaplatos
1564308199,1564308559,360,0.72,4.319999999999999,inodoro
1564308849,1564308863,14,2.21,0.493,lavamanos
1564309701,1564310177,476,1.8738461538461535,7.906,lavaplatos
1564310219,1564310281,62,1.608,0.529,lavamanos
1564311670,1564311719,49,2.0828571428571427,0.83,lavamanos
1564315155,1564315159,4,1.845,0.17,lavaplatos
1564315205,1564315249,44,2.18,0.652,lavamanos
1564323805,1564323815,10,0.6709090909090909,0.123,lavamanos
1564328901,1564328906,5,1.88,0.188,lavaplatos
1564335727,1564335727,1,3.06,0.051,lavamanos
1564341294,1564342139,845,1.1059615384615384,3.56,lavamanos
1564350086,1564350128,42,0.94,0.25,lavamanos
1564355011,1564355140,129,1.8948387096774195,3.109,lavamanos
1564384288,1564384648,360,0.72,4.319999999999999,inodoro
1564384807,1564385167,360,0.72,4.319999999999999,inodoro
1564387116,1564387188,72,1.4515384615384614,0.77,lavamanos
1564389404,1564394166,4762,4.498317757009345,16.98,ducha
1564390658,1564392374,1716,1.4170833333333337,4.467,lavamanos
1564392716,1564393277,561,4.244761904761905,4.764,lavaplatos
1564394653,1564395013,360,0.72,4.319999999999999,inodoro
1564395453,1564395467,14,2.14,0.477,lavamanos
1564428735,1564428749,14,1.9414285714285715,0.489,lavamanos
1564428913,1564428921,8,4.42,0.663,lavaplatos
1564434655,1564434664,9,0.6342857142857142,0.119,lavamanos
1564436639,1564436650,11,1.38,0.282,lavamanos
1564437071,1564437431,360,0.72,4.319999999999999,inodoro
1564468021,1564468300,279,1.6263157894736842,5.417,lavaplatos
1564469372,1564469425,53,2.4654545454545453,1.013,lavamanos
1564470052,1564470059,7,1.5375,0.205,lavamanos
1564474935,1564475104,169,3.7446511627906975,8.579,lavaplatos
1564476054,1564476171,117,1.7976623376623375,2.538,lavamanos
1564476161,1564476555,394,4.697741935483871,30.873,ducha
1564477138,1564477398,260,1.21,0.242,lavamanos
1564488914,1564488959,45,2.01,1.55,lavamanos
1564489597,1564490365,768,4.513846153846154,0.988,lavaplatos
1564492761,1564494161,1400,2.2915,36.451,lavaplatos
1564494270,1564494315,45,1.8776470588235288,0.628,lavamanos
1564494455,1564494815,360,0.72,4.319999999999999,inodoro
1564499093,1564499453,360,0.72,4.319999999999999,inodoro
1564500763,1564500832,69,1.4431578947368422,0.645,lavamanos
1564502052,1564504282,2230,4.577598152424942,35.192,ducha
1564504352,1564504712,360,0.72,4.319999999999999,inodoro
1564504355,1564504387,32,1.872,0.295,lavamanos
1564514118,1564514130,12,1.46,0.312,lavamanos
1564515255,1564517779,2524,2.0394893617021275,47.224,lavaplatos
1564520226,1564520240,14,0.8871428571428571,0.227,lavamanos
1564523781,1564523791,10,3.924,0.656,lavaplatos
1564526420,1564526780,360,0.72,4.319999999999999,inodoro
1564526433,1564526518,85,1.8865384615384613,1.796,lavamanos
1564554376,1564554613,237,1.966153846153846,0.891,lavamanos
1564554565,1564554925,360,0.72,4.319999999999999,inodoro
1564555046,1564557371,2325,1.88,1.309,lavaplatos
1564556123,1564556326,203,5.1371875000000005,17.434,ducha
1564556152,1564557205,1053,2.128920863309353,7.494,lavamanos
1564602760,1564603120,360,0.72,4.319999999999999,inodoro
1564605319,1564605679,360,0.72,4.319999999999999,inodoro
1564933194,1564933318,124,1.0913793103448275,2.277,lavaplatos
1564933548,1564933651,103,0.7133333333333334,0.317,lavamanos
1564936174,1564936876,702,2.057894736842105,2.374,lavamanos
1564936432,1564936792,360,0.72,4.319999999999999,inodoro
1564936563,1564936923,360,0.72,4.319999999999999,inodoro
1564937423,1564937835,412,3.852713178294573,26.438,ducha
1564937486,1564937613,127,4.2,1.427,lavamanos
1564938390,1564938404,14,1.2085714285714284,0.295,lavamanos
1564938574,1564938588,14,3.564,0.689,lavaplatos
1564939270,1564939353,83,0.87,0.268,lavamanos
1564941001,1564941361,360,0.72,4.319999999999999,inodoro
1564957055,1564957074,19,0.8084210526315788,0.269,lavamanos
1564957265,1564957356,91,1.2584415584415585,1.796,lavaplatos
1564962824,1564962933,109,2.311578947368421,1.938,lavamanos
1564986529,1564986625,96,0.8966666666666666,0.735,lavamanos
1564986639,1564986999,360,0.72,4.319999999999999,inodoro
1564988883,1564988883,1,0.36,0.006,lavamanos
1564988926,1564989135,209,1.4904545454545453,4.019,lavaplatos
1564992086,1564992446,360,0.72,4.319999999999999,inodoro
1564992316,1564992523,207,2.0770212765957443,3.864,lavamanos
1564994945,1564994953,8,0.62,0.079,lavamanos
1565000527,1565000680,153,2.597454545454545,3.52,lavamanos
1565015687,1565015736,49,1.0242857142857142,0.329,lavamanos
1565015775,1565023046,7271,2.358136882129277,109.133,lavaplatos
1565017146,1565017159,13,0.7476923076923077,0.175,lavamanos
1565019378,1565019421,43,3.033333333333333,0.606,lavamanos
1565020481,1565020527,46,4.188,0.929,lavamanos
1565021800,1565021948,148,3.225,3.787,lavamanos
1565023478,1565024514,1036,1.4898529411764705,6.772,lavamanos
1565024849,1565025114,265,4.705,9.844,lavaplatos
1565027026,1565027042,16,1.5719999999999998,0.424,lavamanos
1565028138,1565028796,658,1.824,21.179,lavaplatos
1565029257,1565031205,1948,3.416746987951807,20.574,ducha
1565031739,1565031744,5,0.47,0.047,lavamanos
1565032583,1565034080,1497,2.305,0.471,lavaplatos
1565033255,1565033256,1,4.71,0.157,lavamanos
1565034186,1565034193,7,3.036,0.378,lavamanos
1565034248,1565034608,360,0.72,4.319999999999999,inodoro
1565037133,1565037250,117,5.16,5.26,lavaplatos
1565039162,1565040759,1597,2.772972972972973,22.213,lavaplatos
1565039433,1565039445,12,4.42,0.886,lavamanos
1565040615,1565040757,142,3.591428571428571,8.548,lavamanos
1565040810,1565041170,360,0.72,4.319999999999999,inodoro
1565043143,1565043411,268,3.41625,1.066,lavamanos
1565045703,1565047697,1994,1.508344370860927,19.592,lavaplatos
1565047447,1565047807,360,0.72,4.319999999999999,inodoro
1565047531,1565047540,9,2.478,0.413,lavamanos
1565047667,1565048027,360,0.72,4.319999999999999,inodoro
1565047952,1565048312,360,0.72,4.319999999999999,inodoro
1565049605,1565050089,484,2.9039296187683283,17.93,lavaplatos
1565049647,1565049662,15,1.988,0.539,lavamanos
1565050353,1565050499,146,1.2514285714285711,1.12,lavamanos
1565075667,1565076027,360,0.72,4.319999999999999,inodoro
1565076519,1565076528,9,2.76,0.328,lavaplatos
1565077930,1565077947,17,1.46625,0.449,lavamanos
1565079783,1565081948,2165,2.138680203045685,12.773,lavaplatos
1565081245,1565081245,1,0.6599999999999999,0.011,lavamanos
1565086400,1565086449,49,0.8485714285714285,0.418,lavaplatos
1565086838,1565086870,32,1.5799999999999998,0.275,lavamanos
1565091684,1565091705,21,1.92,0.678,lavaplatos
1565096419,1565096779,360,0.72,4.319999999999999,inodoro
1565098011,1565098371,360,0.72,4.319999999999999,inodoro
1565099346,1565100384,1038,3.10953488372093,22.493,lavaplatos
1565104086,1565104093,7,0.855,0.096,lavaplatos
1565108224,1565108774,550,1.2888,3.481,lavamanos
1565109557,1565109588,31,1.23,0.208,lavamanos
1565201842,1565202362,520,1.8484931506849316,3.015,lavamanos
1565201924,1565201927,3,0.96,0.064,lavaplatos
1565202965,1565203325,360,0.72,4.319999999999999,inodoro
1565257019,1565257379,360,0.72,4.319999999999999,inodoro
1565286355,1565286923,568,2.3921739130434783,3.372,lavaplatos
1565286401,1565286451,50,2.3657142857142857,1.932,lavamanos
1565287685,1565288045,360,0.72,4.319999999999999,inodoro
1565287770,1565288130,360,0.72,4.319999999999999,inodoro
1565338448,1565338475,27,1.5557142857142856,0.422,lavaplatos
1565342230,1565342242,12,0.4919999999999999,0.075,lavaplatos
1565342263,1565342334,71,2.427,0.958,lavamanos
1565346976,1565347336,360,0.72,4.319999999999999,inodoro
1565352183,1565352196,13,2.82,0.671,lavaplatos
1565359455,1565359581,126,2.240869565217391,3.272,lavamanos
1565360265,1565360276,11,1.4345454545454546,0.265,lavamanos
1565373564,1565375114,1550,2.52,0.862,lavaplatos
1565373722,1565373740,18,1.2282352941176469,0.394,lavamanos
1565374534,1565374613,79,2.149090909090909,1.405,lavamanos
1565376078,1565376143,65,2.092,0.739,lavamanos
1565376728,1565377088,360,0.72,4.319999999999999,inodoro
1565714939,1565714956,17,1.05,0.563,lavamanos
1565714978,1565715022,44,3.0388235294117645,1.353,lavaplatos
1565716805,1565717165,360,0.72,4.319999999999999,inodoro
1565718083,1565718860,777,0.8960869565217391,1.289,lavamanos
1565718580,1565719413,833,4.4651918735891645,43.399,ducha
1565719552,1565720234,682,1.8127659574468085,1.828,lavamanos
1565736665,1565736681,16,0.92625,0.267,lavamanos
1565764311,1565764320,9,2.418,0.403,lavaplatos
1565770733,1565772175,1442,1.351578947368421,6.52,lavaplatos
1565772793,1565772802,9,0.6,0.164,ducha
1565800731,1565801091,360,0.72,4.319999999999999,inodoro
1565857968,1565858328,360,0.72,4.319999999999999,inodoro
1565858086,1565858446,360,0.72,4.319999999999999,inodoro
1565866814,1565867174,360,0.72,4.319999999999999,inodoro
1565871745,1565871784,39,0.34,0.165,lavamanos
1565871753,1565872113,360,0.72,4.319999999999999,inodoro
1565873958,1565874181,223,2.3434285714285714,3.478,lavaplatos
1565874514,1565874558,44,1.152,0.287,lavamanos
1565875373,1565875733,360,0.72,4.319999999999999,inodoro
1565877785,1565878145,360,0.72,4.319999999999999,inodoro
1565884675,1565888231,3556,3.99,26.094,ducha
1565885035,1565885423,388,2.0866666666666664,2.422,lavamanos
1565888024,1565888397,373,1.5794117647058823,5.206,lavamanos
1565891181,1565891194,13,2.346,0.451,lavaplatos
1565892166,1565892526,360,0.72,4.319999999999999,inodoro
1565892622,1565892982,360,0.72,4.319999999999999,inodoro
1565895695,1565895703,8,1.5074999999999998,0.203,lavaplatos
1565898291,1565898309,18,1.7,0.546,lavamanos
1565898633,1565898663,30,1.6392,0.744,lavaplatos
1565903354,1565903407,53,1.66,0.341,lavamanos
1565940480,1565942023,1543,2.55875,4.181,lavaplatos
1565942055,1565942415,360,0.72,4.319999999999999,inodoro
1565942101,1565942281,180,1.2135211267605632,1.732,lavamanos
1565942139,1565942499,360,0.72,4.319999999999999,inodoro
1565942351,1565942711,360,0.72,4.319999999999999,inodoro
1565945599,1565948720,3121,0.4499999999999999,8.306,ducha
1565946559,1565947039,480,0.18,0.006,lavamanos
1565948360,1565948360,1,1.74,0.029,lavamanos
1565951704,1565951757,53,2.675,0.689,lavamanos
1565953580,1565955259,1679,0.2599999999999999,6.475,ducha
1565954299,1565954299,1,0.54,0.009,lavamanos
1565956045,1565957903,1858,1.697142857142857,31.28,lavaplatos
1565960789,1565962400,1611,1.7147368421052631,6.619,lavaplatos
1565973583,1565973603,20,2.043,0.719,lavamanos
1565974293,1565976246,1953,0.5563636363636364,0.972,lavaplatos
1565978320,1565978361,41,1.185,0.322,lavamanos
1565978993,1565979600,607,1.1775,11.283,lavaplatos
1565983726,1565984300,574,0.18,0.006,lavamanos
1565983726,1565987475,3749,3.367984790874525,80.122,ducha
1565986119,1565986479,360,0.72,4.319999999999999,inodoro
1565987033,1565987043,10,4.325454545454545,0.793,lavaplatos
1565987228,1565987704,476,1.6228571428571428,1.86,lavamanos
1565992079,1565992439,360,0.72,4.319999999999999,inodoro
1565995124,1565995137,13,2.778461538461538,0.656,lavaplatos
1565995241,1565995601,360,0.72,4.319999999999999,inodoro
1566022060,1566024532,2472,2.982676056338028,10.432,lavaplatos
1566027606,1566031739,4133,2.428387096774194,9.207,lavaplatos
1566028290,1566028298,8,0.7424999999999999,0.114,lavamanos
1566031163,1566031332,169,1.87,3.331,lavamanos
1566031375,1566031735,360,0.72,4.319999999999999,inodoro
1566032087,1566032133,46,1.3139999999999998,0.293,lavamanos
1566151865,1566151909,44,0.324,0.12,lavamanos
1566153965,1566154540,575,1.1466666666666665,0.182,lavaplatos
1566153998,1566154215,217,1.3450909090909091,7.308,lavamanos
1566157160,1566157206,46,1.153333333333333,0.35,lavamanos
1566157738,1566158098,360,0.72,4.319999999999999,inodoro
1566158819,1566158825,6,1.38,0.128,lavaplatos
1566158990,1566159033,43,1.217142857142857,0.364,lavamanos
1566195278,1566195686,408,2.723076923076923,15.197,lavaplatos
1566197265,1566198263,998,1.672881355932203,5.089,lavamanos
1566198424,1566198876,452,1.9157142857142853,6.044,lavaplatos
1566199130,1566199490,360,0.72,4.319999999999999,inodoro
1566199188,1566199387,199,5.904497041420118,19.52,ducha
1566199220,1566199314,94,4.1175,4.227,lavamanos
1566202716,1566202763,47,1.6305882352941174,0.526,lavamanos
1566204226,1566204327,101,0.6369230769230769,1.036,lavamanos
1566204347,1566204707,360,0.72,4.319999999999999,inodoro
1566205378,1566205738,360,0.72,4.319999999999999,inodoro
1566492043,1566492102,59,1.5635294117647058,1.324,lavaplatos
1566492492,1566492852,360,0.72,4.319999999999999,inodoro
1566492701,1566493061,360,0.72,4.319999999999999,inodoro
1566492849,1566492938,89,2.4234146341463414,1.834,lavamanos
1566493095,1566493481,386,4.680494505494505,30.169,ducha
1566493707,1566493770,63,1.7166666666666666,1.048,lavamanos
1566494683,1566495043,360,0.72,4.319999999999999,inodoro
1566742907,1566743707,800,0.6927272727272726,0.171,lavaplatos
1566747408,1566747426,18,1.9166666666666663,0.613,lavaplatos
1566747968,1566748814,846,2.908398576512455,22.233,lavamanos
1566752895,1566753198,303,1.3172727272727272,4.308,lavamanos
1566754775,1566755135,360,0.72,4.319999999999999,inodoro
1566755051,1566755053,2,0.6599999999999999,0.024,lavaplatos
1566804312,1566804672,360,0.72,4.319999999999999,inodoro
1566842773,1566843133,360,0.72,4.319999999999999,inodoro
1566850636,1566850996,360,0.72,4.319999999999999,inodoro
1567101734,1567101920,186,0.15,0.528,lavamanos
1567102619,1567102671,52,1.1127272727272728,0.288,lavamanos
1567102739,1567103229,490,3.5047058823529413,20.741,lavaplatos
1567105995,1567106078,83,0.8925,0.278,lavamanos
1567106229,1567106241,12,0.744,0.078,lavaplatos
1567139045,1567139405,360,0.72,4.319999999999999,inodoro
1567148947,1567149089,142,2.556,4.491,lavaplatos
1567155976,1567155979,3,2.265,0.151,lavaplatos
1567160990,1567161014,24,0.91,0.382,lavamanos
1567163884,1567168943,5059,2.3110243902439023,43.773,lavaplatos
1567168960,1567169320,360,0.72,4.319999999999999,inodoro
1567174920,1567175115,195,0.919891304347826,3.006,ducha
1567177583,1567177650,67,0.8999999999999999,0.24,lavamanos
1567178396,1567178999,603,0.84,0.349,lavamanos
1567179525,1567181191,1666,2.084262295081967,13.52,lavaplatos
1567179717,1567180077,360,0.72,4.319999999999999,inodoro
1567185728,1567185734,6,1.66,0.197,lavaplatos
1567187075,1567187200,125,2.1954545454545453,1.205,lavamanos
1567189541,1567189547,6,1.512,0.13,lavaplatos
1567190896,1567191016,120,2.796666666666667,1.097,lavamanos
1567192109,1567192310,201,1.329,5.387,lavaplatos
1567192812,1567193633,821,1.0180645161290325,1.026,lavamanos
1567192966,1567194040,1074,4.460963855421687,32.823,ducha
1567194319,1567194437,118,0.8918918918918919,1.263,lavamanos
1567232690,1567232695,5,3.132,0.328,lavaplatos
1567235056,1567235416,360,0.72,4.319999999999999,inodoro
1567240369,1567240480,111,1.4563636363636363,0.736,lavamanos
1567241242,1567241352,110,1.9137142857142857,3.545,lavaplatos
1567241828,1567241904,76,1.847142857142857,0.561,lavamanos
1567247130,1567252302,5172,2.491746031746032,20.332,lavaplatos
1567249490,1567249850,360,0.72,4.319999999999999,inodoro
1567253047,1567253119,72,2.46,0.815,lavamanos
1567261866,1567262226,360,0.72,4.319999999999999,inodoro
1567266349,1567267966,1617,1.7822981366459625,10.782,lavamanos
1567268055,1567268225,170,4.359503105590061,12.383,ducha
1567269822,1567270113,291,1.192,0.47,lavamanos
1567270672,1567271032,360,0.72,4.319999999999999,inodoro
1567279246,1567279255,9,2.96,0.5,lavaplatos
1567284452,1567284462,10,0.888,0.17,lavamanos
1567306062,1567306122,60,1.42,0.413,lavamanos
1567321985,1567321990,5,1.59,0.159,lavaplatos
1567328321,1567329961,1640,2.2570212765957445,8.793,lavaplatos
1567330250,1567330610,360,0.72,4.319999999999999,inodoro
1567348897,1567349257,360,0.72,4.319999999999999,inodoro
1567349232,1567349569,337,2.1907317073170733,6.247,lavaplatos
1567355801,1567356161,360,0.72,4.319999999999999,inodoro
1567359004,1567359068,64,0.69,0.168,lavamanos
1567359267,1567360987,1720,1.7110344827586206,2.255,lavaplatos
1567362171,1567362531,360,0.72,4.319999999999999,inodoro
1567368324,1567368428,104,0.715,0.515,lavamanos
1567404044,1567405344,1300,3.828787878787879,14.611,ducha
1567404169,1567404476,307,1.448,2.236,lavaplatos
1567405147,1567405634,487,3.024146341463415,4.81,lavamanos
1567406308,1567406723,415,1.0324137931034485,0.537,lavamanos
1567407531,1567407891,360,0.72,4.319999999999999,inodoro
1567445568,1567445629,61,0.8788235294117647,0.352,lavamanos
1567448931,1567449841,910,2.330909090909091,5.858,lavaplatos
1567451677,1567452037,360,0.72,4.319999999999999,inodoro
1567451700,1567451727,27,3.234782608695652,1.306,lavaplatos
1567457179,1567457261,82,2.535,2.631,lavaplatos
1567458169,1567458253,84,2.0217391304347827,0.937,lavamanos
1567459264,1567459288,24,0.965,0.404,lavamanos
1567459612,1567459972,360,0.72,4.319999999999999,inodoro
1567492539,1567493141,602,1.2085714285714284,0.165,lavaplatos
1567493157,1567493164,7,0.99,0.132,lavamanos
1567493531,1567493891,360,0.72,4.319999999999999,inodoro
1567493928,1567494045,117,1.610322580645161,1.934,lavamanos
1567494113,1567494265,152,4.422083333333333,11.245,ducha
1567520742,1567520800,58,0.90375,0.345,lavamanos
1567521882,1567521883,1,0.51,0.017,lavamanos
1567526321,1567528157,1836,1.7264516129032257,6.774,lavaplatos
1567526342,1567526369,27,0.6599999999999999,0.074,lavamanos
1567532456,1567533183,727,3.0997183098591545,5.03,lavaplatos
1567534005,1567534030,25,2.5325,1.066,lavamanos
1567541130,1567541455,325,0.7716666666666666,1.95,lavamanos
1567558222,1567558401,179,0.6399999999999999,1.388,lavamanos
1567577176,1567577536,360,0.72,4.319999999999999,inodoro
1567578891,1567578964,73,1.1264516129032258,0.708,lavamanos
1567581609,1567582057,448,1.3404878048780486,3.536,lavamanos
1567582378,1567582399,21,3.55875,1.033,lavaplatos
1567589931,1567589968,37,0.92,0.158,lavamanos
1567592440,1567592506,66,1.725,1.496,lavamanos
1567599362,1567599406,44,0.84,0.259,lavamanos
1567599553,1567600770,1217,3.256595744680851,8.293,lavaplatos
1567603848,1567604208,360,0.72,4.319999999999999,inodoro
1567609365,1567609409,44,0.8630769230769231,0.251,lavamanos
1567611175,1567611344,169,2.2208823529411763,4.049,lavamanos
1567628430,1567628479,49,1.5415384615384615,0.511,lavamanos
1567628711,1567629186,475,2.668905109489051,13.629,lavaplatos
1567631493,1567631538,45,1.23,0.466,lavamanos
1567631690,1567631719,29,3.281538461538461,1.492,lavaplatos
1567633908,1567633916,8,2.6,0.39,lavaplatos
1567663161,1567663325,164,1.3242857142857145,2.153,lavaplatos
1567663684,1567664303,619,2.9475,3.4,lavamanos
1567664174,1567665281,1107,3.9266666666666654,23.437,ducha
1567664920,1567664961,41,0.705,0.18,lavamanos
1567665692,1567665731,39,0.68,0.136,lavamanos
1567665864,1567666224,360,0.72,4.319999999999999,inodoro
1567666141,1567666154,13,0.936,0.164,lavaplatos
1567699392,1567699439,47,2.025,0.709,lavamanos
1567699686,1567700200,514,1.0292307692307692,0.233,lavaplatos
1567702783,1567702837,54,1.7485714285714284,0.775,lavamanos
1567710648,1567710850,202,1.5314285714285716,2.02,lavamanos
1567711210,1567711570,360,0.72,4.319999999999999,inodoro
1567726363,1567726487,124,1.44,1.848,lavamanos
1567749448,1567749461,13,1.968,0.396,lavaplatos
1567749607,1567750021,414,1.5275,2.051,lavamanos
1567749788,1567750031,243,4.761315789473684,19.291,ducha
1567750839,1567751053,214,0.73125,4.247,lavamanos
1567751262,1567751622,360,0.72,4.319999999999999,inodoro
1567795546,1567795559,13,2.165,0.482,lavamanos
1567797002,1567797053,51,1.82,0.65,lavamanos
1567800433,1567800470,37,0.8925,0.179,lavamanos
1567825993,1567826353,360,0.72,4.319999999999999,inodoro
1567826033,1567826068,35,2.271176470588235,1.316,ducha
1567826167,1567826176,9,0.72,0.06,lavaplatos
1567845614,1567845839,225,1.9937704918032784,4.513,lavaplatos
1567846538,1567846898,360,0.72,4.319999999999999,inodoro
1567852399,1567852583,184,3.237,9.179,lavaplatos
1567860179,1567860537,358,2.37,11.309,lavaplatos
1567867439,1567867472,33,1.7825,0.771,lavaplatos
1567869516,1567869529,13,0.1599999999999999,0.03,lavamanos
1567873494,1567873854,360,0.72,4.319999999999999,inodoro
1567874228,1567875010,782,4.113394495412844,27.326,ducha
1567874513,1567874532,19,3.101052631578947,1.038,lavaplatos
1567874793,1567876299,1506,1.3735031847133756,6.62,lavamanos
1567877293,1567877653,360,0.72,4.319999999999999,inodoro
1567960593,1567960625,32,3.0923076923076924,0.712,lavaplatos
1567960723,1567960724,1,0.39,0.013,lavamanos
1567963699,1567964059,360,0.72,4.319999999999999,inodoro
1567963864,1567965006,1142,2.262857142857143,15.233,lavaplatos
1567965102,1567965118,16,0.264,0.074,lavamanos
1567967143,1567967148,5,2.4,0.164,lavaplatos
1567975258,1567975618,360,0.72,4.319999999999999,inodoro
1568006526,1568006537,11,1.98,0.263,lavaplatos
1568006975,1568008242,1267,1.5739393939393935,4.355,lavamanos
1568007060,1568007208,148,4.462714285714286,11.056,ducha
1568058413,1568058773,360,0.72,4.319999999999999,inodoro
1568058564,1568059281,717,2.47875,13.77,lavaplatos
1568063277,1568063845,568,1.51725,2.249,lavamanos
1568063335,1568063695,360,0.72,4.319999999999999,inodoro
1568092848,1568092853,5,1.45,0.145,lavaplatos
1568093160,1568093318,158,2.515636363636364,4.959,lavamanos
1568093387,1568093619,232,4.352054794520548,16.894,ducha
1568094525,1568094618,93,0.8533333333333333,0.66,lavamanos
1568094732,1568095092,360,0.72,4.319999999999999,inodoro
1568100303,1568100663,360,0.72,4.319999999999999,inodoro
1568114171,1568114183,12,0.46,0.06,lavaplatos
1568114358,1568114517,159,2.7271875,4.08,lavamanos
1568151987,1568153537,1550,2.3428037383177567,7.984,lavamanos
1568152595,1568153074,479,5.511466666666667,44.074,ducha
1568181753,1568181988,235,2.058125,3.966,lavamanos
1568183938,1568184684,746,1.1325,0.398,lavaplatos
1568184762,1568185122,360,0.72,4.319999999999999,inodoro
1568377243,1568377259,16,2.8425,0.805,lavamanos
1568377481,1568377488,7,3.9857142857142858,0.543,lavaplatos
1568378336,1568378337,1,2.34,0.078,lavamanos
1568397603,1568398155,552,0.8742857142857142,0.238,lavamanos
1568397957,1568398874,917,1.86,4.98,lavaplatos
1568398352,1568398712,360,0.72,4.319999999999999,inodoro
1568401003,1568402753,1750,2.5955844155844154,4.557,lavamanos
1568402219,1568402672,453,2.0841176470588234,9.394,lavaplatos
1568408911,1568409002,91,1.7147368421052631,0.725,lavamanos
1568426271,1568426631,360,0.72,4.319999999999999,inodoro
1568426515,1568426581,66,2.6133333333333333,0.578,lavamanos
1568426553,1568426913,360,0.72,4.319999999999999,inodoro
1568428432,1568428471,39,0.6142105263157894,0.409,lavamanos
1568441548,1568441908,360,0.72,4.319999999999999,inodoro
1568442733,1568442743,10,0.5519999999999999,0.094,lavaplatos
1568443612,1568444224,612,3.625333333333333,2.855,lavamanos
1568446937,1568446960,23,2.141052631578947,0.805,lavaplatos
1568451143,1568451457,314,2.738064516129032,4.742,lavamanos
1568452198,1568452204,6,1.46,0.148,lavamanos
1568455477,1568455837,360,0.72,4.319999999999999,inodoro
1568463455,1568466116,2661,3.217894736842105,26.742,lavaplatos
1568465247,1568465254,7,1.637142857142857,0.193,lavamanos
1568468139,1568468235,96,2.88,0.654,lavamanos
1568468144,1568470552,2408,4.89,63.69,ducha
1568470105,1568470123,18,3.15,0.702,lavaplatos
1568470507,1568470698,191,2.613684210526316,4.757,lavamanos
1568482406,1568483289,883,2.657142857142857,0.62,lavaplatos
1568484843,1568485203,360,0.72,4.319999999999999,inodoro
1568566477,1568567013,536,2.192142857142857,1.103,lavamanos
1568569449,1568569462,13,2.934545454545454,0.544,lavaplatos
1568569672,1568570032,360,0.72,4.319999999999999,inodoro
1568573121,1568574968,1847,2.843333333333333,12.273,lavaplatos
1568574530,1568574592,62,1.3125,0.285,lavamanos
1568574532,1568574892,360,0.72,4.319999999999999,inodoro
1568582301,1568582363,62,0.978,0.444,lavamanos
1568582823,1568582840,17,3.221538461538461,0.766,lavaplatos
1568611279,1568611639,360,3.27,12.97,lavaplatos
1568613527,1568613887,360,0.72,4.319999999999999,inodoro
1568655692,1568656052,360,0.72,4.319999999999999,inodoro
1568655882,1568656473,591,4.353352941176471,33.923,ducha
1568657228,1568657588,360,0.72,4.319999999999999,inodoro
1568657351,1568657711,360,0.72,4.319999999999999,inodoro
1568673410,1568674139,729,1.6347169811320754,3.169,lavaplatos
1568673445,1568673880,435,1.4982352941176469,1.278,lavamanos
1568676098,1568676285,187,3.383076923076923,3.423,lavamanos
1568701040,1568701047,7,2.262857142857143,0.266,lavamanos
1568701665,1568701718,53,3.663157894736842,2.348,lavaplatos
1568702165,1568702525,360,0.72,4.319999999999999,inodoro
1568702409,1568702585,176,3.727368421052632,3.985,lavamanos
1568704919,1568705443,524,2.065,1.543,lavamanos
1568705381,1568707092,1711,2.4385714285714286,0.661,lavaplatos
1568706830,1568707190,360,0.72,4.319999999999999,inodoro
1568707389,1568708243,854,2.128695652173913,4.526,lavamanos
1568714618,1568714631,13,1.984615384615385,0.472,lavamanos
1568715706,1568716066,360,0.72,4.319999999999999,inodoro
1568716190,1568716239,49,1.6885714285714284,0.283,lavamanos
1568716765,1568716773,8,4.095,0.566,lavaplatos
1568722535,1568722552,17,0.48,0.078,lavaplatos
1568726651,1568726736,85,2.42,1.184,lavamanos
1568735705,1568735777,72,0.8999999999999999,0.341,lavamanos
1568738691,1568738767,76,1.540909090909091,0.711,lavamanos
1568748742,1568751414,2672,2.5509278350515463,28.687,lavaplatos
1568751651,1568751926,275,1.706470588235294,4.281,lavamanos
1568753142,1568753502,360,0.72,4.319999999999999,inodoro
1568789045,1568789067,22,3.0409090909090906,1.171,lavaplatos
1568790594,1568790954,360,0.72,4.319999999999999,inodoro
1568794124,1568794130,6,2.5542857142857143,0.298,lavaplatos
1568795988,1568798402,2414,0.4679999999999999,0.491,ducha
1568796911,1568797271,360,0.72,4.319999999999999,inodoro
1568796972,1568797076,104,0.8039999999999999,0.324,lavamanos
1568798221,1568798678,457,1.4258823529411764,0.553,lavamanos
1568799568,1568799639,71,1.9907142857142857,1.091,lavamanos
1568803951,1568804311,360,0.72,4.319999999999999,inodoro
1568807151,1568814334,7183,3.013559322033898,120.448,lavaplatos
1568808253,1568808613,360,0.72,4.319999999999999,inodoro
1568808412,1568808493,81,3.06,0.915,lavamanos
1568812879,1568812950,71,1.272,0.292,lavamanos
1568813259,1568813619,360,0.72,4.319999999999999,inodoro
1568814382,1568814396,14,0.9369230769230767,0.223,lavamanos
1568816639,1568816657,18,1.5074999999999998,0.408,lavaplatos
1568816737,1568816748,11,1.422,0.243,lavamanos
1568819264,1568822173,2909,5.041348314606742,56.863,ducha
1568819354,1568819714,360,0.72,4.319999999999999,inodoro
1568819891,1568820019,128,2.218,2.564,lavamanos
1568821317,1568822118,801,2.559310344827586,5.121,lavamanos
1568822828,1568823279,451,1.3363636363636364,0.621,lavamanos
1568839102,1568839168,66,1.445454545454545,0.408,lavamanos
1568840263,1568840276,13,0.725,0.16,lavamanos
1568873603,1568873615,12,3.03,0.569,lavaplatos
1568874444,1568874778,334,2.0223529411764702,0.696,lavamanos
1568874455,1568874815,360,0.72,4.319999999999999,inodoro
1568878096,1568878392,296,1.9418181818181817,1.243,lavamanos
1568878413,1568879576,1163,2.43,3.669,lavaplatos
1568882147,1568882193,46,1.14,0.196,lavamanos
1568884773,1568884789,16,1.698,0.357,lavaplatos
1568884795,1568887215,2420,3.926808510638297,61.473,ducha
1568884820,1568884842,22,2.0485714285714285,0.757,lavamanos
1568886801,1568888911,2110,2.3625563909774434,12.656,lavamanos
1568889214,1568889574,360,0.72,4.319999999999999,inodoro
1568931389,1568931449,60,1.3863157894736842,0.55,lavamanos
1568958342,1568958347,5,3.05,0.305,lavaplatos
1568958530,1568958823,293,2.0009174311926605,6.556,lavamanos
1568959467,1568959942,475,1.221,2.769,lavamanos
1568964309,1568964669,360,0.72,4.319999999999999,inodoro
1569019966,1569020154,188,2.064,0.563,lavamanos
1569020052,1569020053,1,0.4499999999999999,0.015,lavaplatos
1569021286,1569021334,48,2.213684210526316,0.804,lavamanos
1569023729,1569024089,360,0.72,4.319999999999999,inodoro
1569042666,1569042671,5,0.12,0.012,lavaplatos
1569046790,1569047531,741,2.908888888888889,7.929,lavaplatos
1569048455,1569048815,360,0.72,4.319999999999999,inodoro
1569049854,1569050754,900,1.63125,3.879,lavaplatos
1569050082,1569051561,1479,2.4225,5.301,lavamanos
1569050507,1569051173,666,5.59211009174312,15.642,ducha
1569051592,1569051952,360,0.72,4.319999999999999,inodoro
1569052044,1569052404,360,0.72,4.319999999999999,inodoro
1569062974,1569062986,12,0.12,0.026,lavaplatos
1569066309,1569066358,49,0.7885714285714285,0.267,lavamanos
1569069676,1569069691,15,2.524,0.685,lavamanos
1569069960,1569071439,1479,2.7625210084033616,7.222,lavaplatos
1569070662,1569071022,360,0.72,4.319999999999999,inodoro
1569070840,1569071200,360,0.72,4.319999999999999,inodoro
1569079229,1569079257,28,1.206923076923077,0.556,lavamanos
1569080217,1569080577,360,0.72,4.319999999999999,inodoro
1569081692,1569081830,138,2.176216216216216,1.626,lavamanos
1569088377,1569090968,2591,3.664477611940298,8.155,lavaplatos
1569091116,1569091172,56,1.27875,0.45,lavamanos
1569091173,1569091533,360,0.72,4.319999999999999,inodoro
1569095209,1569095429,220,3.6597029702970296,13.336,ducha
1569095286,1569096188,902,2.000869565217392,7.423,lavamanos
1569104856,1569104873,17,2.050588235294118,0.626,lavamanos
1569134457,1569134463,6,2.7,0.315,lavaplatos
1569137713,1569138204,491,2.792307692307692,8.167,lavaplatos
1569139031,1569139333,302,5.211188811188811,26.373,ducha
1569139082,1569139124,42,3.399512195121951,2.435,lavamanos
1569139479,1569139839,360,0.72,4.319999999999999,inodoro
1569141086,1569141134,48,1.1325,0.233,lavamanos
1569141827,1569141894,67,2.22,0.591,lavamanos
1569142834,1569142837,3,1.425,0.095,lavaplatos
1569143101,1569143461,360,0.72,4.319999999999999,inodoro
1569186917,1569187254,337,1.6627397260273973,2.138,lavamanos
1569200533,1569200676,143,2.2455172413793103,3.609,lavamanos
1569216928,1569218285,1357,2.67301775147929,13.207,lavamanos
1569216999,1569217359,360,0.72,4.319999999999999,inodoro
1569217300,1569218207,907,2.4657142857142857,0.905,lavaplatos
1569217896,1569218065,169,5.029014084507042,14.418,ducha
1569219090,1569219863,773,2.288780487804878,4.405,lavamanos
1569219321,1569219681,360,0.72,4.319999999999999,inodoro
1569227442,1569227487,45,1.87,0.267,lavamanos
1569241255,1569241263,8,3.3,0.436,lavamanos
1569241267,1569245772,4505,3.575016393442623,31.644,lavaplatos
1569248513,1569248516,3,3.66,0.244,lavaplatos
1569249494,1569249854,360,0.72,4.319999999999999,inodoro
1569249999,1569250041,42,4.237894736842105,2.916,lavamanos
1569256780,1569257140,360,0.72,4.319999999999999,inodoro
1569260359,1569261499,1140,3.361967213114754,3.611,ducha
1569276724,1569278943,2219,1.562142857142857,3.06,lavaplatos
1569276797,1569276852,55,2.033333333333333,0.729,lavamanos
1569277444,1569277804,360,0.72,4.319999999999999,inodoro
1569277595,1569277966,371,2.179787234042553,5.558,lavamanos
1569278346,1569278706,360,0.72,4.319999999999999,inodoro
1569279028,1569279388,360,0.72,4.319999999999999,inodoro
1569304502,1569304580,78,1.963636363636364,0.496,lavamanos
1569304922,1569304926,4,3.4679999999999995,0.289,lavaplatos
1569305450,1569305699,249,2.038448275862069,4.732,lavamanos
1569306478,1569306861,383,1.7352631578947368,1.282,lavamanos
1569306869,1569307229,360,0.72,4.319999999999999,inodoro
1569308098,1569308150,52,1.332,0.207,lavamanos
1569315889,1569315939,50,0.3299999999999999,0.109,lavamanos
1569327302,1569327599,297,4.688669201520912,21.832,ducha
1569327390,1569327445,55,5.320588235294117,3.389,lavamanos
1569328922,1569329037,115,2.3545945945945945,1.918,lavamanos
1569338006,1569338366,360,0.72,4.319999999999999,inodoro
1569338445,1569339055,610,2.304705882352941,1.47,lavamanos
1569338730,1569338744,14,2.9353846153846157,0.694,lavaplatos
1569344860,1569345220,360,0.72,4.319999999999999,inodoro
1569347493,1569347952,459,1.5402272727272728,2.825,lavamanos
1569361781,1569361799,18,0.9633333333333334,0.307,lavamanos
1569362028,1569362388,360,0.72,4.319999999999999,inodoro
1569383789,1569384028,239,5.877599999999999,23.363,ducha
1569383838,1569383957,119,4.406769230769231,5.178,lavamanos
1569385119,1569385566,447,1.8916666666666664,3.324,lavamanos
1569385833,1569385837,4,2.64,0.22,lavaplatos
1569386204,1569386564,360,0.72,4.319999999999999,inodoro
1569427939,1569428458,519,2.3566666666666665,0.97,lavamanos
1569429129,1569429723,594,2.1526027397260274,3.469,lavamanos
1569429603,1569429607,4,3.108,0.259,lavaplatos
1569450002,1569450055,53,1.135,0.331,lavamanos
1569480663,1569482333,1670,2.878292682926829,50.614,lavaplatos
1569480963,1569481323,360,0.72,4.319999999999999,inodoro
1569482243,1569482603,360,0.72,4.319999999999999,inodoro
1569487323,1569487368,45,2.4646153846153847,0.656,lavaplatos
1569492953,1569493013,60,2.664705882352941,0.892,lavamanos
1569493181,1569496179,2998,2.4265822784810123,62.642,lavaplatos
1569494286,1569494843,557,1.635,0.636,lavamanos
1569495993,1569496353,360,0.72,4.319999999999999,inodoro
1569499739,1569499798,59,2.608695652173913,1.846,lavaplatos
1569506294,1569506483,189,2.676521739130435,4.543,lavaplatos
1569507587,1569507947,360,0.72,4.319999999999999,inodoro
1569509036,1569509496,460,3.4859447004608293,26.747,ducha
1569509128,1569509972,844,3.38936170212766,3.47,lavamanos
1569511811,1569512033,222,1.592,6.442,lavamanos
1569512240,1569512600,360,0.72,4.319999999999999,inodoro
1569512268,1569512290,22,3.5863636363636364,1.382,lavaplatos
1569523454,1569523503,49,1.3963636363636365,0.345,lavamanos
1569523846,1569525965,2119,2.712931034482758,5.568,lavaplatos
1569529920,1569529926,6,0.8142857142857143,0.095,lavamanos
1569534556,1569534566,10,1.92,0.263,lavaplatos
1569534849,1569534937,88,2.035384615384615,0.631,lavamanos
1569534882,1569535242,360,0.72,4.319999999999999,inodoro
1569565068,1569565428,360,0.72,4.319999999999999,inodoro
1569567092,1569567452,360,0.72,4.319999999999999,inodoro
1569574618,1569574623,5,0.2599999999999999,0.019,lavaplatos
1569574646,1569574650,4,1.095,0.075,lavamanos
1569586246,1569586246,1,0.54,0.009,lavamanos
1569604323,1569604683,360,0.72,4.319999999999999,inodoro
1569605210,1569605496,286,2.945,14.192,ducha
1569605296,1569605439,143,5.746315789473684,6.095,lavamanos
1569606218,1569606692,474,2.33625,0.729,lavamanos
1569606912,1569613158,6246,2.4994029850746267,62.035,lavaplatos
1569607728,1569607773,45,2.13,0.601,lavamanos
1569610735,1569611095,360,0.72,4.319999999999999,inodoro
1569612181,1569612541,360,0.72,4.319999999999999,inodoro
1569612288,1569612301,13,1.5199999999999998,0.341,lavamanos
1569613171,1569613218,47,1.356923076923077,0.391,lavamanos
1569616192,1569616252,60,0.7733333333333333,0.22,lavaplatos
1569616418,1569617332,914,2.444885496183206,7.566,lavamanos
1569631717,1569631772,55,1.4899999999999998,0.554,lavamanos
1569631801,1569632161,360,0.72,4.319999999999999,inodoro
1569655153,1569656362,1209,2.8965625,11.636,lavaplatos
1569656219,1569656323,104,1.7599999999999998,1.28,lavamanos
1569659693,1569659705,12,7.195,1.583,lavaplatos
1569661481,1569661546,65,2.748,0.896,lavamanos
1569666097,1569667696,1599,1.4563917525773196,9.473,lavamanos
1569667115,1569667475,360,0.72,4.319999999999999,inodoro
1569668068,1569668073,5,1.656,0.158,lavaplatos
1569669928,1569669986,58,1.9,1.813,lavaplatos
1569676362,1569676437,75,3.168461538461538,3.193,lavamanos
1569676424,1569676539,115,5.518681318681318,10.829,ducha
1569677539,1569677593,54,1.686,0.409,lavamanos
1569678742,1569678792,50,1.7,0.264,lavamanos
1569678992,1569679352,360,0.72,4.319999999999999,inodoro
1569695977,1569698813,2836,2.801721854304636,14.92,lavaplatos
1569696067,1569696130,63,2.725714285714285,0.825,lavamanos
1569702702,1569702723,21,1.6894736842105262,0.606,lavamanos
1569705936,1569706010,74,1.27,0.409,lavamanos
1569740837,1569741197,360,0.72,4.319999999999999,inodoro
1569741572,1569741642,70,1.8085714285714285,0.572,lavamanos
1569743391,1569743397,6,2.2885714285714287,0.267,lavaplatos
1569748141,1569748191,50,2.361,0.961,lavaplatos
1569748445,1569749533,1088,0.7475,0.848,lavamanos
1569748843,1569749203,360,0.72,4.319999999999999,inodoro
1569748852,1569751200,2348,5.243826366559485,59.496,ducha
1569751704,1569752526,822,2.914639175257732,5.984,lavamanos
1569752922,1569752928,6,1.332,0.158,lavaplatos
1569777112,1569777119,7,1.38,0.185,lavaplatos
1569777552,1569777593,41,2.5036363636363634,0.577,lavamanos
1569777582,1569777942,360,0.72,4.319999999999999,inodoro
1569780106,1569780871,765,0.18,3.062,ducha
1569780342,1569780702,360,0.72,4.319999999999999,inodoro
1569780481,1569782161,1680,2.0104477611940297,8.459,lavamanos
1569789845,1569789884,39,1.548,0.991,lavaplatos
1569790138,1569790227,89,1.0578947368421052,1.118,lavamanos
1569792519,1569792564,45,1.1742857142857144,0.248,lavamanos
1569793865,1569795328,1463,1.487142857142857,0.347,lavaplatos
1569795736,1569795807,71,1.01625,0.415,lavamanos
1569821071,1569821157,86,1.7733333333333334,1.158,lavaplatos
1569821553,1569821642,89,1.2014285714285715,1.806,lavamanos
1569821674,1569821823,149,5.374789915966386,13.667,ducha
1569822002,1569822362,360,0.72,4.319999999999999,inodoro
1569822384,1569822896,512,1.508823529411765,3.181,lavamanos
1569823291,1569823651,360,0.72,4.319999999999999,inodoro
1569829819,1569830521,702,2.2423529411764704,2.335,lavamanos
1569831533,1569831893,360,0.72,4.319999999999999,inodoro
1569834050,1569834109,59,2.033333333333333,0.447,lavamanos
1569837636,1569837712,76,0.3299999999999999,0.686,lavamanos
1569838605,1569838690,85,2.790731707317073,2.095,lavamanos
1569865051,1569865062,11,1.445454545454545,0.301,lavamanos
1569867573,1569867579,6,0.42,0.029,lavaplatos
1569867867,1569867918,51,2.511,0.95,lavamanos
1569872429,1569873524,1095,3.073846153846154,14.068,lavaplatos
1569872474,1569872474,1,1.3199999999999998,0.022,lavamanos
1569880212,1569880572,360,0.72,4.319999999999999,inodoro
1569911506,1569911866,360,0.72,4.319999999999999,inodoro
1569911774,1569912634,860,2.2766666666666664,1.88,lavaplatos
1569912972,1569913025,53,0.9728571428571428,0.307,lavamanos
1569913004,1569913364,360,0.72,4.319999999999999,inodoro
1569914081,1569914146,65,1.3714285714285714,0.306,lavamanos
1569915889,1569916249,360,0.72,4.319999999999999,inodoro
1569915955,1569916108,153,4.838823529411764,8.589,lavaplatos
1569918064,1569918403,339,2.582222222222222,8.492,lavaplatos
1569920288,1569921145,857,1.38,0.342,lavaplatos
1569923723,1569923758,35,0.4679999999999999,0.101,lavamanos
1569929850,1569930235,385,2.01,1.631,lavaplatos
1569934474,1569934481,7,0.984,0.122,lavaplatos
1569943560,1569944259,699,2.614736842105263,11.95,lavamanos
1569943714,1569944074,360,0.72,4.319999999999999,inodoro
1569944273,1569944527,254,5.0415,21.472,ducha
1569946276,1569946636,360,0.72,4.319999999999999,inodoro
1569947363,1569947397,34,2.4496551724137934,1.245,lavaplatos
1569947387,1569948415,1028,2.3295652173913046,2.022,lavamanos
1569948548,1569948908,360,0.72,4.319999999999999,inodoro
1570031289,1570031732,443,0.2,0.076,lavamanos
1570031731,1570032686,955,0.4,0.02,lavaplatos
1570032685,1570032685,1,1.3199999999999998,0.022,lavamanos
1570036830,1570036830,1,1.08,0.018,lavamanos
1570111186,1570111448,262,2.232,5.104,lavamanos
1570111445,1570112443,998,2.847272727272727,0.618,lavaplatos
1570112367,1570112436,69,1.6430769230769229,0.504,lavamanos
1570135273,1570136763,1490,1.64625,0.509,lavaplatos
1570140216,1570142052,1836,5.430412844036697,41.853,ducha
1570140234,1570140594,360,0.72,4.319999999999999,inodoro
1570141033,1570141393,360,0.72,4.319999999999999,inodoro
1570142400,1570142585,185,1.0758620689655172,2.758,lavamanos
1570168799,1570168869,70,1.3199999999999998,0.554,lavaplatos
1570169337,1570169745,408,2.761764705882353,4.989,lavamanos
1570170036,1570170396,360,0.72,4.319999999999999,inodoro
1570170528,1570171017,489,1.647857142857143,2.306,lavamanos
1570171061,1570171421,360,0.72,4.319999999999999,inodoro
1570193241,1570193298,57,1.3425,0.31,lavamanos
1570194783,1570194792,9,0.2914285714285713,0.06,lavaplatos
1570195060,1570195325,265,2.2210344827586206,10.408,ducha
1570195144,1570195793,649,3.813857142857143,11.187,lavamanos
1570196551,1570196560,9,0.7333333333333333,0.123,lavamanos
1570222993,1570223327,334,1.8854545454545453,1.277,lavamanos
1570223391,1570223410,19,2.3833333333333333,0.719,lavaplatos
1570225510,1570225514,4,0.852,0.071,lavamanos
1570225562,1570225922,360,0.72,4.319999999999999,inodoro
1570251991,1570252030,39,1.47,0.215,lavamanos
1570256511,1570257195,684,3.6888888888888887,3.072,lavaplatos
1570259133,1570259493,360,0.72,4.319999999999999,inodoro
1570263371,1570263447,76,2.74,0.872,lavamanos
1570265102,1570265122,20,2.488421052631579,0.837,lavaplatos
1570271713,1570271769,56,2.35875,0.838,lavamanos
1570273450,1570275015,1565,3.039493670886076,6.45,lavaplatos
1570280370,1570280375,5,2.46,0.207,lavaplatos
1570281126,1570281486,360,0.72,4.319999999999999,inodoro
1570282558,1570282564,6,2.34,0.273,lavaplatos
1570287053,1570287138,85,2.558181818181818,1.12,lavamanos
1570292044,1570292404,360,0.72,4.319999999999999,inodoro
1570292311,1570292656,345,2.8782089552238803,3.494,lavamanos
1570292358,1570292565,207,3.4512244897959183,11.99,ducha
1570293421,1570293839,418,1.417894736842105,0.647,lavamanos
1570297693,1570297700,7,0.6825,0.091,lavamanos
1570299957,1570300130,173,3.56,2.338,lavamanos
1570300642,1570301002,360,0.72,4.319999999999999,inodoro
1570314158,1570314438,280,0.7911111111111111,0.435,lavamanos
1570344377,1570344990,613,2.4727272727272727,19.357,lavaplatos
1570345837,1570346197,360,0.72,4.319999999999999,inodoro
1570348543,1570348948,405,4.252,19.385,lavaplatos
1570354267,1570361051,6784,2.5943697478991594,20.835,lavaplatos
1570355821,1570356094,273,2.438181818181818,7.819,lavamanos
1570357133,1570357493,360,0.72,4.319999999999999,inodoro
1570363557,1570367256,3699,3.4390443686006824,47.089,lavaplatos
1570367501,1570367861,360,0.72,4.319999999999999,inodoro
1570374866,1570376251,1385,3.2248543689320384,6.052,lavamanos
1570375387,1570375747,360,0.72,4.319999999999999,inodoro
1570375425,1570377482,2057,3.793208430913349,29.039,ducha
1570377328,1570377845,517,4.297538461538462,15.159,lavamanos
1570391959,1570391971,12,1.8553846153846156,0.402,lavamanos
1570392573,1570392933,360,0.72,4.319999999999999,inodoro
1570394186,1570394783,597,1.604,0.411,lavaplatos
1570394823,1570394886,63,1.5074999999999998,0.525,lavamanos
1570429666,1570429846,180,1.7957142857142856,3.435,lavaplatos
1570432077,1570432437,360,0.72,4.319999999999999,inodoro
1570437438,1570438257,819,2.359411764705882,4.801,lavamanos
1570448996,1570449047,51,1.96,0.607,lavamanos
1570456227,1570456288,61,1.332,0.225,lavamanos
1570464110,1570464470,360,0.72,4.319999999999999,inodoro
1570473754,1570474639,885,4.17,121.247,ducha
1570474638,1570474638,1,9.54,0.159,lavamanos
1570479172,1570479251,79,1.0885714285714283,0.273,lavamanos
1570480451,1570480811,360,0.72,4.319999999999999,inodoro
1570511957,1570511966,9,2.06,0.347,lavaplatos
1570512570,1570513494,924,6.456112412177985,78.541,ducha
1570512757,1570513048,291,1.4928947368421053,3.421,lavamanos
1570513674,1570514089,415,2.8849484536082475,5.009,lavamanos
1570515175,1570515202,27,0.8025,0.163,lavamanos
1570525571,1570525595,24,2.64,1.105,lavamanos
1570532808,1570533168,360,0.72,4.319999999999999,inodoro
1570551862,1570553096,1234,1.11375,5.447,lavaplatos
1570552517,1570552651,134,5.048333333333333,11.384,ducha
1570552521,1570552904,383,4.278947368421052,10.134,lavamanos
1570557989,1570560563,2574,3.503,4.042,lavaplatos
1570560296,1570560929,633,2.1875,2.935,lavamanos
1570560357,1570560717,360,0.72,4.319999999999999,inodoro
1570575450,1570575495,45,1.540909090909091,0.642,lavamanos
1570600580,1570600940,360,0.72,4.319999999999999,inodoro
1570600900,1570600941,41,1.2814285714285714,0.674,lavaplatos
1570600967,1570601558,591,1.8535922330097088,3.729,lavamanos
1570600977,1570601740,763,5.864324324324324,27.98,ducha
1570601060,1570601420,360,0.72,4.319999999999999,inodoro
1570602245,1570602698,453,1.0658823529411765,1.144,lavamanos
1570650574,1570652726,2152,5.609828571428571,52.396,ducha
1570650617,1570650655,38,2.614285714285714,0.662,lavamanos
1570651583,1570652656,1073,2.43144578313253,10.923,lavamanos
1570652554,1570652914,360,0.72,4.319999999999999,inodoro
1570687481,1570688368,887,2.4,0.582,lavaplatos
1570687932,1570689100,1168,2.106131386861314,6.884,lavamanos
1570688883,1570689243,360,0.72,4.319999999999999,inodoro
1570701436,1570701796,360,0.72,4.319999999999999,inodoro
1570705691,1570705766,75,1.7914285714285714,0.347,lavamanos
1570712636,1570712834,198,1.491428571428571,0.558,lavaplatos
1570715372,1570715410,38,3.21,0.387,lavaplatos
1570715951,1570716113,162,3.95945945945946,9.981,lavamanos
1570715982,1570716112,130,5.542439024390244,12.16,ducha
1570717868,1570718008,140,5.685,5.414,lavamanos
1570718641,1570718756,115,1.5472727272727274,1.344,lavamanos
1570720363,1570720805,442,3.320869565217391,11.028,lavaplatos
1570723841,1570724321,480,4.98,0.166,lavaplatos
1570725796,1570726156,360,0.72,4.319999999999999,inodoro
1570726630,1570727168,538,1.92,1.6,lavamanos
1570726782,1570727142,360,0.72,4.319999999999999,inodoro
1570741473,1570741549,76,1.1785714285714286,0.412,lavamanos
1570742479,1570742485,6,2.58,0.301,lavaplatos
1570749821,1570749892,71,1.66125,0.586,lavamanos
1570772932,1570772937,5,2.25,0.225,lavaplatos
1570773192,1570773615,423,5.03565,35.543,ducha
1570773223,1570774106,883,2.4804,6.413,lavamanos
1570775181,1570775186,5,0.69,0.05,lavaplatos
1570775310,1570775378,68,1.542857142857143,0.304,lavamanos
1570820016,1570820076,60,2.1381818181818177,0.539,lavamanos
1570820263,1570820305,42,1.1228571428571428,1.427,lavaplatos
1570831861,1570832221,360,0.72,4.319999999999999,inodoro
1570831920,1570832280,360,0.72,4.319999999999999,inodoro
1570839813,1570839818,5,0.12,0.012,lavaplatos
1570859881,1570860755,874,2.3188235294117647,22.223,lavaplatos
1570861099,1570862048,949,2.9495454545454542,11.357,lavamanos
1570862196,1570862326,130,6.486341463414634,14.122,ducha
1570862684,1570862745,61,1.8075,0.389,lavamanos
1570863422,1570863782,360,0.72,4.319999999999999,inodoro
1570863766,1570864074,308,3.1740659340659336,10.081,lavamanos
1570865400,1570865410,10,1.446,0.274,lavamanos
1570869447,1570869547,100,2.7184615384615385,2.681,lavaplatos
1570875757,1570876117,360,0.72,4.319999999999999,inodoro
1570889758,1570889820,62,2.1375,0.451,lavamanos
1570889840,1570890200,360,0.72,4.319999999999999,inodoro
1570891039,1570891132,93,2.59,0.74,lavamanos
1570891066,1570891426,360,0.72,4.319999999999999,inodoro
1570894688,1570894827,139,3.30734693877551,3.296,lavaplatos
1570896515,1570896540,25,2.032,0.573,lavamanos
1570896697,1570914779,18082,2.8865671641791044,274.711,lavaplatos
1570900159,1570900199,40,2.0123076923076924,0.492,lavamanos
1570905745,1570905842,97,3.3128571428571427,1.02,lavamanos
1570906509,1570907388,879,4.111463414634146,12.146,lavamanos
1570906721,1570907081,360,0.72,4.319999999999999,inodoro
1570907368,1570907728,360,0.72,4.319999999999999,inodoro
1570914799,1570914826,27,2.725,0.642,lavamanos
1570916977,1570917023,46,2.773333333333333,0.492,lavaplatos
1570917818,1570919155,1337,2.7964285714285717,1.777,lavamanos
1570918098,1570918458,360,0.72,4.319999999999999,inodoro
1570919015,1570923176,4161,2.9370762711864407,44.646,lavaplatos
1570920732,1570921092,360,0.72,4.319999999999999,inodoro
1570923643,1570923701,58,0.8047058823529412,0.325,lavamanos
1570924009,1570924369,360,0.72,4.319999999999999,inodoro
1570939675,1570939807,132,2.014482758620689,3.199,lavamanos
1570947004,1570947009,5,0.12,0.012,lavaplatos
1570950291,1570950631,340,1.9745454545454544,8.869,lavaplatos
1570950741,1570951101,360,0.72,4.319999999999999,inodoro
1570951701,1570952061,360,0.72,4.319999999999999,inodoro
1570953153,1570953229,76,2.215384615384615,1.107,lavamanos
1570953256,1570953673,417,2.6675,14.063,lavaplatos
1570956009,1570956024,15,0.9514285714285714,0.181,lavaplatos
1570956249,1570956609,360,0.72,4.319999999999999,inodoro
1570956489,1570956562,73,1.065,0.211,lavamanos
1570959645,1570960005,360,0.72,4.319999999999999,inodoro
1570964055,1570964063,8,2.35,0.241,lavaplatos
1570969581,1570970243,662,1.874210526315789,1.376,lavamanos
1570970205,1570970565,360,0.72,4.319999999999999,inodoro
1570971116,1570971125,9,2.5885714285714285,0.308,lavaplatos
1570972497,1570972722,225,5.62169014084507,21.123,ducha
1570972835,1570972894,59,2.892,2.594,lavamanos
1570975808,1570976168,360,0.72,4.319999999999999,inodoro
1570976360,1570977502,1142,3.3311842105263154,17.999,lavamanos
1570976492,1570976912,420,5.639545454545455,39.541,ducha
1570978200,1570978207,7,0.585,0.078,lavamanos
1570979612,1570979972,360,0.72,4.319999999999999,inodoro
1570980814,1570981141,327,2.672903225806452,11.611,lavaplatos
1570986929,1570986952,23,4.909999999999999,0.527,lavamanos
1570990557,1570990606,49,2.307272727272727,0.501,lavamanos
1571001252,1571001612,360,0.72,4.319999999999999,inodoro
1571001301,1571001717,416,1.14,11.179,lavaplatos
1571003457,1571003519,62,2.4222222222222225,2.085,lavamanos
1571031072,1571031432,360,0.72,4.319999999999999,inodoro
1571031793,1571031802,9,1.725,0.234,lavaplatos
1571031827,1571033587,1760,2.238561151079137,6.327,lavamanos
1571033993,1571034353,360,0.72,4.319999999999999,inodoro
1571058849,1571061544,2695,2.901760563380282,15.46,ducha
1571058977,1571059468,491,2.9,11.307,lavamanos
1571061294,1571061452,158,5.921818181818182,3.693,lavamanos
1571073226,1571073230,4,0.56,0.058,lavaplatos
1571078487,1571078847,360,0.72,4.319999999999999,inodoro
1571080964,1571081100,136,0.8781818181818182,0.905,lavaplatos
1571081011,1571081059,48,1.5138461538461538,0.434,lavamanos
1571081120,1571081480,360,0.72,4.319999999999999,inodoro
1571094055,1571094601,546,3.1382142857142856,3.353,lavamanos
1571094198,1571094203,5,0.312,0.028,lavaplatos
1571119250,1571120750,1500,1.8096774193548384,1.471,lavaplatos
1571119555,1571119910,355,1.6244444444444444,1.401,lavamanos
1571119555,1571119815,260,5.972903225806451,17.576,ducha
1571120879,1571121887,1008,2.43873417721519,6.136,lavamanos
1571125965,1571126044,79,1.4657142857142855,0.418,lavamanos
1571136327,1571136345,18,0.88125,0.254,lavamanos
1571137511,1571140221,2710,2.955584415584416,9.974,lavaplatos
1571146288,1571146712,424,3.44855421686747,13.793,lavaplatos
1571147458,1571147818,360,0.72,4.319999999999999,inodoro
1571147849,1571149058,1209,5.107846153846154,23.464,ducha
1571148537,1571148831,294,2.68,3.103,lavamanos
1571149371,1571149731,360,0.72,4.319999999999999,inodoro
1571150599,1571150959,360,0.72,4.319999999999999,inodoro
1571203710,1571203716,6,0.8799999999999999,0.106,lavaplatos
1571204078,1571204478,400,6.215,20.613,ducha
1571205546,1571205906,360,0.72,4.319999999999999,inodoro
1571206040,1571206060,20,1.4584615384615385,0.332,lavaplatos
1571206131,1571206719,588,2.83978021978022,7.212,lavamanos
1571206768,1571207128,360,0.72,4.319999999999999,inodoro
1571256089,1571256144,55,1.8675,0.891,lavamanos
1571259631,1571259684,53,2.593846153846154,0.696,lavamanos
1571291425,1571291785,360,0.72,4.319999999999999,inodoro
1571291480,1571292457,977,1.4942307692307693,1.897,lavamanos
1571291480,1571291997,517,5.423949044585987,46.151,ducha
1571293056,1571293063,7,3.4679999999999995,0.295,lavaplatos
1571293401,1571293510,109,1.9420408163265304,1.894,lavamanos
1571294363,1571294630,267,1.816551724137931,1.08,lavamanos
1571330762,1571330834,72,1.383529411764706,0.531,lavamanos
1571331157,1571332131,974,2.822857142857143,13.054,lavaplatos
1571331622,1571331691,69,2.115,1.002,lavamanos
1571340076,1571340307,231,5.149816513761468,19.906,ducha
1571340124,1571340829,705,1.9549253731343283,3.43,lavamanos
1571341002,1571341362,360,0.72,4.319999999999999,inodoro
1571355238,1571355317,79,2.055,0.547,lavamanos
1571355709,1571355714,5,0.12,0.012,lavaplatos
1571379034,1571379342,308,2.045121951219512,3.075,lavamanos
1571380005,1571380271,266,1.983,8.564,lavaplatos
1571380923,1571381344,421,1.6471875,2.195,lavamanos
1571381487,1571381847,360,0.72,4.319999999999999,inodoro
1571418717,1571418787,70,2.112,0.308,lavamanos
1571419389,1571419539,150,2.004657534246576,2.752,lavamanos
1571419579,1571419873,294,3.830935251798561,18.854,ducha
1571422116,1571422626,510,1.215,0.704,lavamanos
1571424251,1571424263,12,0.12,0.026,lavamanos
1571451541,1571451901,360,0.72,4.319999999999999,inodoro
1571468205,1571468565,360,0.72,4.319999999999999,inodoro
1571471356,1571474271,2915,2.570027247956403,37.321,lavaplatos
1571474859,1571475784,925,1.8194366197183096,2.469,lavamanos
1571474859,1571475046,187,5.915060240963855,17.614,ducha
1571481184,1571481327,143,2.361428571428571,1.924,lavamanos
1571483480,1571483516,36,0.4466666666666666,0.428,lavaplatos
1571488019,1571488379,360,0.72,4.319999999999999,inodoro
1571488431,1571492041,3610,3.614413407821229,100.69,lavaplatos
1571489835,1571490195,360,0.72,4.319999999999999,inodoro
1571489868,1571489899,31,3.518181818181818,0.766,lavamanos
1571490054,1571490414,360,0.72,4.319999999999999,inodoro
1571490876,1571491236,360,0.72,4.319999999999999,inodoro
1571491242,1571491297,55,2.8425,0.475,lavamanos
1571493555,1571493571,16,2.84625,0.822,lavamanos
1571494389,1571494486,97,2.897368421052632,4.778,lavamanos
1571495224,1571495231,7,1.38,0.121,lavaplatos
1571495846,1571495923,77,3.957272727272727,1.642,lavamanos
1571496596,1571496849,253,3.0810878661087866,13.006,ducha
1571496697,1571496869,172,5.41906976744186,14.386,lavamanos
1571497294,1571497380,86,4.6777500000000005,6.575,lavaplatos
1571497381,1571497741,360,0.72,4.319999999999999,inodoro
1571498056,1571498178,122,2.0967567567567564,1.571,lavamanos
1571505452,1571506190,738,2.9966666666666666,15.878,lavaplatos
1571509419,1571509598,179,4.828588235294117,14.539,ducha
1571509453,1571510820,1367,2.1402197802197804,3.785,lavamanos
1571554280,1571556691,2411,1.8272727272727272,0.343,lavaplatos
1571555129,1571555129,1,0.6599999999999999,0.011,lavamanos
1571556524,1571556884,360,0.72,4.319999999999999,inodoro
1571558430,1571558790,360,0.72,4.319999999999999,inodoro
1571559378,1571560423,1045,2.0142857142857142,0.239,lavaplatos
1571563177,1571563271,94,1.4475,3.647,lavaplatos
1571563994,1571564138,144,2.5244444444444443,2.584,lavamanos
1571684986,1571685065,79,0.702,0.268,lavamanos
1571685580,1571688700,3120,3.0333644859813083,38.497,lavaplatos
1571695653,1571695768,115,3.5896153846153847,3.424,lavamanos
1571725945,1571726305,360,0.72,4.319999999999999,inodoro
1571726241,1571726973,732,0.885,0.426,lavaplatos
1571731255,1571731615,360,0.72,4.319999999999999,inodoro
1571736369,1571736852,483,3.2348936170212768,5.431,lavamanos
1571737461,1571737505,44,0.56,0.196,lavamanos
1571742555,1571742712,157,2.17875,4.767,lavamanos
1571744967,1571746302,1335,2.599811320754717,40.76,lavaplatos
1571748809,1571749169,360,0.72,4.319999999999999,inodoro
1571751474,1571751564,90,2.209090909090909,0.988,lavamanos
1571751529,1571751889,360,0.72,4.319999999999999,inodoro
1571759300,1571759572,272,3.213157894736842,6.675,lavaplatos
1571759513,1571759528,15,0.952,0.242,lavamanos
1571763293,1571763351,58,0.8772413793103448,0.51,lavamanos
1571764495,1571764525,30,1.9933333333333327,0.983,lavaplatos
1571768460,1571768699,239,6.155588235294117,24.593,ducha
1571771470,1571773916,2446,2.973939393939394,22.463,lavaplatos
1571773088,1571773488,400,3.2688311688311686,6.617,lavamanos
1571809840,1571810352,512,3.954315789473684,22.63,lavaplatos
1571811173,1571811825,652,1.8146938775510204,4.009,lavamanos
1571812433,1571812827,394,2.0568,1.095,lavamanos
1571813831,1571813854,23,1.968,0.615,lavamanos
1571813879,1571814239,360,0.72,4.319999999999999,inodoro
1571873033,1571873135,102,1.7339999999999998,0.778,lavamanos
1571895038,1571895679,641,4.60656108597285,44.804,ducha
1571895062,1571895422,360,0.72,4.319999999999999,inodoro
1571895669,1571896159,490,2.4646153846153847,3.842,lavamanos
1571897092,1571897138,46,2.306666666666666,0.422,lavaplatos
1571897207,1571897453,246,2.0342307692307693,3.588,lavamanos
1571943840,1571945015,1175,2.2864864864864862,3.736,lavamanos
1571958456,1571958540,84,1.892,0.615,lavamanos
1571959033,1571959393,360,0.72,4.319999999999999,inodoro
1571966730,1571967069,339,1.5763636363636364,4.741,lavamanos
1571966747,1571967107,360,0.72,4.319999999999999,inodoro
1571981290,1571981712,422,3.2117142857142857,4.395,lavamanos
1571981449,1571981879,430,3.962216748768473,28.447,ducha
1571981770,1571982130,360,0.72,4.319999999999999,inodoro
1571982360,1571982408,48,2.6914285714285717,0.482,lavaplatos
1571982536,1571982929,393,1.1614285714285717,0.436,lavamanos
1572008588,1572008724,136,3.3011764705882354,3.446,lavamanos
1572036111,1572036129,18,1.7223529411764706,0.523,lavamanos
1572036231,1572036251,20,2.0752941176470587,0.645,lavaplatos
1572052337,1572052463,126,1.7307692307692308,2.166,lavamanos
1572059977,1572060337,360,0.72,4.319999999999999,inodoro
1572070655,1572070663,8,2.025,0.272,lavaplatos
1572070829,1572071066,237,4.548191489361702,18.127,ducha
1572070865,1572071029,164,4.0712,5.62,lavamanos
1572076254,1572076583,329,1.726046511627907,3.227,lavamanos
1572089345,1572089405,60,1.92,0.482,lavamanos
1572089807,1572090167,360,0.72,4.319999999999999,inodoro
1572097289,1572097293,4,2.136,0.178,lavaplatos
1572103521,1572103770,249,2.104109589041096,4.038,lavamanos
1572103840,1572104200,360,0.72,4.319999999999999,inodoro
1572120192,1572120535,343,4.658490566037736,14.076,ducha
1572120399,1572121132,733,3.0026086956521736,2.652,lavamanos
1572121389,1572121749,360,0.72,4.319999999999999,inodoro
1572141663,1572141720,57,0.67125,0.274,lavamanos
1572147698,1572148026,328,1.5683544303797468,2.705,lavamanos
1572160935,1572161295,360,0.72,4.319999999999999,inodoro
1572176104,1572177668,1564,4.777735849056604,13.699,ducha
1572176129,1572176987,858,1.998904109589041,6.334,lavamanos
1572177846,1572178280,434,2.8053061224489797,2.577,lavamanos
1572209636,1572209656,20,1.548,0.28,lavamanos
1572211102,1572211462,360,0.72,4.319999999999999,inodoro
1572213688,1572218022,4334,4.306347305389221,27.21,ducha
1572213948,1572214082,134,3.105154639175258,5.464,lavamanos
1572216508,1572216526,18,2.36,0.753,lavaplatos
1572216970,1572217095,125,1.8457142857142856,2.222,lavamanos
1572217452,1572217812,360,0.72,4.319999999999999,inodoro
1572217874,1572217959,85,3.535,2.349,lavamanos
1572218238,1572218598,360,0.72,4.319999999999999,inodoro
1572247501,1572247731,230,1.422127659574468,1.212,lavamanos
1572248577,1572249924,1347,2.031063829787234,6.778,lavaplatos
1572249468,1572249828,360,0.72,4.319999999999999,inodoro
1572249528,1572249692,164,1.88,3.889,lavamanos
1572252584,1572253864,1280,4.256793893129771,29.678,lavaplatos
1572259805,1572259807,2,0.8799999999999999,0.044,lavaplatos
1572260007,1572260040,33,1.056,0.204,lavamanos
1572262703,1572263644,941,4.497975460122699,59.21,ducha
1572263991,1572264489,498,1.6181818181818182,1.959,lavamanos
1572275886,1572275928,42,5.466153846153846,3.815,ducha
1572284113,1572284126,13,1.895,0.408,lavaplatos
1572287955,1572288377,422,2.68271186440678,11.048,lavamanos
1572290440,1572290497,57,0.3359999999999999,0.134,lavamanos
1572291381,1572292469,1088,3.0315,22.55,lavaplatos
1572293428,1572294833,1405,2.2107042253521123,5.864,lavamanos
1572294977,1572295078,101,2.611428571428572,3.097,lavaplatos
1572295542,1572295616,74,3.520327868852459,3.791,lavamanos
1572298139,1572298219,80,1.94,1.033,lavamanos
1572299860,1572300220,360,0.72,4.319999999999999,inodoro
1572300509,1572300548,39,1.008,0.293,lavamanos
1572301658,1572302018,360,0.72,4.319999999999999,inodoro
1572302580,1572302940,360,0.72,4.319999999999999,inodoro
1593677421,1593677522,101,0.735,0.688,lavamanos
1593677480,1593677914,434,1.701176470588235,2.189,lavaplatos
1593677548,1593677572,24,1.86,0.799,ducha
1593678800,1593678837,37,1.0399999999999998,0.57,lavamanos
1593681142,1593681261,119,1.7443636363636363,2.268,lavamanos
1593684865,1593684905,40,1.8218181818181816,0.544,lavamanos
1593687434,1593687740,306,1.9159259259259256,7.251,lavamanos
1593691394,1593692562,1168,1.790204081632653,5.27,lavaplatos
1593691509,1593691876,367,0.945,0.245,lavamanos
1593694824,1593695029,205,1.9949068322981367,5.997,lavamanos
1593695998,1593696070,72,2.3485714285714288,0.406,lavaplatos
1593703872,1593705210,1338,1.4334146341463414,16.896,lavaplatos
1593707409,1593707909,500,5.770595744680851,48.151,ducha
1593707650,1593707692,42,2.4114285714285715,1.084,lavamanos
1593708898,1593708926,28,0.6257142857142857,0.117,lavamanos
1593720727,1593720771,44,3.27,1.516,lavamanos
1593721716,1593721728,12,2.026153846153846,0.439,lavamanos
1593722551,1593724383,1832,2.357931034482758,11.759,lavaplatos
1593727261,1593727275,14,0.24,0.086,lavamanos
1593728452,1593728486,34,3.033333333333333,1.009,lavamanos
1593729173,1593729183,10,0.24,0.026,lavamanos
1593734705,1593735662,957,2.9027848101265823,19.286,lavaplatos
1593734776,1593735364,588,3.448860759493671,5.111,lavamanos
1593736381,1593736388,7,0.5775,0.077,lavamanos
1593740382,1593740424,42,1.5211764705882351,0.512,lavamanos
1593741006,1593741204,198,0.14,0.404,lavaplatos
1593755930,1593756539,609,1.74,4.763,lavaplatos
1593756748,1593756962,214,4.389613259668508,15.537,ducha
1593756780,1593756879,99,3.3939622641509435,4.655,lavamanos
1593757512,1593757516,4,0.516,0.043,lavamanos
1593763955,1593764434,479,1.6933333333333331,0.312,lavamanos
1593768170,1593769965,1795,4.907368421052631,11.596,lavaplatos
1593768627,1593768760,133,4.144918032786885,9.102,ducha
1593768841,1593769226,385,3.0315,2.271,lavamanos
1593830067,1593831673,1606,1.8513461538461535,6.804,ducha
1593831646,1593831674,28,0.5066666666666667,0.134,lavamanos
1593855948,1593856034,86,1.2333333333333334,1.509,lavamanos
1593857164,1593857176,12,1.308,0.253,lavamanos
1593858151,1593860390,2239,2.520454545454545,13.994,lavaplatos
1593858765,1593858779,14,0.8142857142857143,0.205,lavamanos
1593860098,1593860118,20,2.9576470588235293,0.911,lavamanos
1593864524,1593864544,20,2.8229999999999995,0.999,lavamanos
1593870830,1593870850,20,3.582,1.259,lavaplatos
1593873136,1593873399,263,2.657142857142857,9.724,lavaplatos
1593873962,1593875447,1485,5.176444444444445,24.87,ducha
1593874387,1593874417,30,2.472413793103448,1.285,lavamanos
1593875861,1593876464,603,3.4472727272727277,4.127,lavamanos
1593876269,1593876392,123,1.2257142857142855,0.576,lavaplatos
1593885612,1593886142,530,1.7668965517241375,0.927,lavamanos
1593888984,1593890750,1766,1.4458064516129032,19.338,lavaplatos
1593889975,1593890568,593,2.473333333333333,0.828,lavamanos
1593893710,1593895714,2004,2.7413592233009707,7.745,lavaplatos
1593894091,1593894131,40,1.758,0.659,lavamanos
1593895197,1593895586,389,3.142417582417582,5.193,lavamanos
1593898110,1593898656,546,2.46,1.211,lavamanos
1593906263,1593906891,628,2.71875,8.371,lavamanos
1593917713,1593917725,12,1.305,0.186,lavamanos
1593935967,1593936004,37,4.423333333333334,1.461,lavamanos
1593937773,1593938992,1219,2.1337864077669906,10.585,lavaplatos
1593938281,1593938860,579,2.9816129032258063,3.315,lavamanos
1593942258,1593942518,260,1.4894117647058824,4.829,lavaplatos
1593947303,1593947344,41,3.532,1.011,lavamanos
1593948942,1593948991,49,2.961818181818182,0.621,lavamanos
1593952228,1593952249,21,2.473333333333333,0.397,lavamanos
1593952988,1593954721,1733,2.474666666666667,5.565,lavaplatos
1593953259,1593953264,5,2.94,0.294,lavamanos
1593954595,1593954629,34,3.29,1.102,lavamanos
1593955634,1593955652,18,3.214285714285714,0.399,lavamanos
1593957425,1593957441,16,2.6563636363636363,0.562,lavamanos
1593957456,1593957816,360,0.72,4.319999999999999,inodoro
1593958290,1593958650,360,0.72,4.319999999999999,inodoro
1593960656,1593960742,86,1.2436363636363637,0.474,lavamanos
1593962457,1593965530,3073,2.698686131386861,21.02,lavaplatos
1593962858,1593965578,2720,3.84345,27.19,ducha
1593963500,1593963534,34,4.12,1.007,lavamanos
1593964426,1593964464,38,1.9457142857142855,0.789,lavamanos
1593965761,1593966121,360,0.72,4.319999999999999,inodoro
1593966596,1593966633,37,1.5533333333333332,0.291,lavamanos
1593969784,1593972478,2694,2.368095238095238,19.977,lavaplatos
1593971083,1593971107,24,1.65,0.372,lavamanos
1593972964,1593973525,561,5.541818181818181,51.902,ducha
1593973061,1593974048,987,3.339090909090909,3.931,lavamanos
1593974320,1593974416,96,1.1236363636363635,0.378,lavaplatos
1593975975,1593976008,33,2.3345454545454545,0.573,lavamanos
1593976225,1593976585,360,0.72,4.319999999999999,inodoro
1593977371,1593977489,118,2.7215625,3.278,lavamanos
1593979158,1593981222,2064,2.036,1.227,lavaplatos
1593979626,1593979629,3,2.22,0.164,lavamanos
1593980407,1593980439,32,3.2968421052631576,1.148,lavamanos
1593985109,1593985540,431,1.382608695652174,3.033,lavaplatos
1593988012,1593988518,506,3.3114285714285714,4.57,lavaplatos
1593988325,1593988355,30,0.74,0.388,lavamanos
1594014356,1594014716,360,0.72,4.319999999999999,inodoro
1594014762,1594015122,360,0.72,4.319999999999999,inodoro
1594015221,1594015225,4,5.364,0.447,lavaplatos
1594015647,1594015797,150,1.205142857142857,2.349,lavamanos
1594022702,1594022735,33,2.451428571428571,0.394,lavamanos
1594025110,1594025118,8,1.7657142857142856,0.21,lavamanos
1594031499,1594031507,8,3.63,0.558,lavamanos
1594034207,1594034617,410,2.107741935483871,1.823,lavamanos
1594035103,1594036256,1153,2.7023076923076923,1.698,lavaplatos
1594037497,1594037523,26,2.087142857142857,0.562,lavamanos
1594039369,1594041819,2450,2.913243243243244,40.025,lavaplatos
1594041167,1594041191,24,1.365,0.357,lavamanos
1594041485,1594041845,360,0.72,4.319999999999999,inodoro
1594044376,1594044636,260,4.240165289256198,18.359,ducha
1594044550,1594044910,360,0.72,4.319999999999999,inodoro
1594045405,1594045593,188,3.146938775510204,4.256,lavamanos
1594046701,1594047061,360,0.72,4.319999999999999,inodoro
1594047395,1594047438,43,2.681538461538461,1.839,lavaplatos
1594055373,1594057315,1942,1.59,2.654,lavaplatos
1594055797,1594056280,483,1.551219512195122,1.197,lavamanos
1594057423,1594058428,1005,2.2108695652173918,2.252,lavamanos
1594059864,1594059876,12,3.54,0.655,lavamanos
1594060522,1594060787,265,7.931249999999999,3.695,lavaplatos
1594061703,1594062063,360,0.72,4.319999999999999,inodoro
1594062719,1594063079,360,0.72,4.319999999999999,inodoro
1594062810,1594062818,8,3.59,0.454,lavamanos
1594063962,1594064322,360,0.72,4.319999999999999,inodoro
1594064632,1594065337,705,2.86,5.416,lavamanos
1594066490,1594067817,1327,2.996146788990825,8.893,lavaplatos
1594066875,1594067235,360,0.72,4.319999999999999,inodoro
1594066945,1594067883,938,2.0985,1.959,lavamanos
1594070093,1594073814,3721,2.346451612903226,46.677,lavaplatos
1594070322,1594070369,47,2.93,0.377,lavamanos
1594071302,1594071327,25,0.885,0.163,lavamanos
1594072885,1594072916,31,0.975,0.216,lavamanos
1594074016,1594074388,372,1.7584615384615383,0.941,lavamanos
1594083322,1594083338,16,0.12,0.034,lavaplatos
1594101422,1594101782,360,0.72,4.319999999999999,inodoro
1594102140,1594102144,4,3.075,0.211,lavamanos
1594102819,1594102990,171,1.652,0.727,lavaplatos
1594103238,1594103598,360,0.72,4.319999999999999,inodoro
1594103372,1594103501,129,3.82436974789916,8.142,ducha
1594103821,1594104397,576,3.1080952380952382,21.144,lavamanos
1594106853,1594106864,11,0.906,0.168,lavamanos
1594108192,1594108552,360,0.72,4.319999999999999,inodoro
1594108535,1594109513,978,1.785,15.669,lavaplatos
1594109175,1594109222,47,1.83,0.891,lavamanos
1594111194,1594111232,38,1.3714285714285714,0.255,lavamanos
1594118696,1594118942,246,1.98,0.998,lavaplatos
1594121774,1594123934,2160,1.5190243902439025,1.75,lavaplatos
1594125933,1594126463,530,0.5318181818181817,0.247,lavamanos
1594126847,1594127207,360,0.72,4.319999999999999,inodoro
1594131151,1594131164,13,1.002857142857143,0.153,lavaplatos
1594131220,1594131255,35,1.4076923076923076,0.378,lavamanos
1594142453,1594142710,257,0.9771428571428572,0.663,lavaplatos
1594142508,1594142536,28,2.3030769230769232,0.531,lavamanos
1594144972,1594145332,360,0.72,4.319999999999999,inodoro
1594145026,1594145057,31,1.66,0.297,lavamanos
1594148171,1594148326,155,3.8816666666666655,9.918,ducha
1594149259,1594149299,40,4.218857142857143,2.872,lavamanos
1594149955,1594149988,33,2.4066666666666667,0.463,lavamanos
1594158068,1594158428,360,0.72,4.319999999999999,inodoro
1594169444,1594169471,27,2.4466666666666668,0.405,lavamanos
1594191079,1594191439,360,0.72,4.319999999999999,inodoro
1594192367,1594192727,360,0.72,4.319999999999999,inodoro
1594192833,1594194298,1465,2.7125,23.541,lavaplatos
1594195194,1594196277,1083,2.48671875,6.736,lavamanos
1594196010,1594196370,360,0.72,4.319999999999999,inodoro
1594196687,1594197047,360,0.72,4.319999999999999,inodoro
1594200440,1594201591,1151,1.4894117647058824,1.249,lavaplatos
1594201666,1594201799,133,2.9558490566037734,3.232,lavamanos
1594207209,1594208601,1392,2.88,17.678,lavaplatos
1594207356,1594207410,54,1.9523076923076923,1.38,lavamanos
1594210196,1594210556,360,0.72,4.319999999999999,inodoro
1594211942,1594212302,360,0.72,4.319999999999999,inodoro
1594213558,1594213841,283,2.195121951219512,2.753,lavaplatos
1594217407,1594217495,88,1.3418181818181818,0.504,lavamanos
1594218092,1594218943,851,1.5133333333333332,7.668,lavaplatos
1594222803,1594225454,2651,4.704451127819548,55.45,ducha
1594223118,1594223170,52,4.6090909090909085,2.741,lavamanos
1594224291,1594224344,53,1.6389473684210525,0.623,lavamanos
1594224899,1594225259,360,0.72,4.319999999999999,inodoro
1594225034,1594226068,1034,3.1923664122137403,17.284,lavamanos
1594226372,1594226732,360,0.72,4.319999999999999,inodoro
1594227572,1594227604,32,1.5818181818181818,0.383,lavamanos
1594250116,1594250147,31,1.512,0.296,lavamanos
1594250168,1594250528,360,0.72,4.319999999999999,inodoro
1594255620,1594256009,389,1.1347826086956525,0.54,lavamanos
1594275719,1594278673,2954,1.35,1.163,lavaplatos
1594276842,1594277202,360,0.72,4.319999999999999,inodoro
1594276904,1594277939,1035,1.8275471698113208,5.471,lavamanos
1594278778,1594279138,360,0.72,4.319999999999999,inodoro
1594279605,1594279965,360,0.72,4.319999999999999,inodoro
1594284834,1594284880,46,2.134285714285714,0.329,lavamanos
1594287611,1594287622,11,0.1745454545454545,0.034,lavamanos
1594287657,1594287660,3,1.74,0.116,lavaplatos
1594290978,1594291086,108,3.2590243902439027,4.177,lavamanos
1594325270,1594325316,46,0.1599999999999999,0.096,lavaplatos
1594337766,1594338884,1118,1.2839999999999998,2.829,lavamanos
1594338314,1594338334,20,1.2075,0.187,lavaplatos
1594344920,1594344950,30,1.836,0.525,lavamanos
1594363890,1594365574,1684,1.6301694915254237,11.086,lavaplatos
1594364787,1594365147,360,0.72,4.319999999999999,inodoro
1594367841,1594368201,360,0.72,4.319999999999999,inodoro
1594371273,1594371404,131,0.5519999999999999,0.3,lavaplatos
1594373383,1594373743,360,0.72,4.319999999999999,inodoro
1594376115,1594376125,10,0.84,0.113,lavamanos
1594377019,1594377058,39,1.824705882352941,0.633,lavamanos
1594378037,1594378080,43,2.36,0.858,lavamanos
1594379090,1594379570,480,0.4499999999999999,0.015,lavamanos
1594380208,1594383200,2992,2.759372822299652,48.136,lavaplatos
1594380738,1594380776,38,3.9675,0.605,lavamanos
1594381600,1594381628,28,1.4925,0.241,lavamanos
1594383617,1594384572,955,3.569189189189189,11.994,lavamanos
1594384159,1594384449,290,3.802081784386617,18.353,ducha
1594385249,1594385564,315,0.8999999999999999,0.271,lavamanos
1594390991,1594390996,5,1.23,0.123,lavamanos
1594395821,1594395990,169,4.174012738853503,11.685,ducha
1594396070,1594396127,57,3.825882352941176,2.35,lavamanos
1594398218,1594398578,360,0.72,4.319999999999999,inodoro
1594404621,1594404981,360,0.72,4.319999999999999,inodoro
1594405267,1594405479,212,2.6426086956521737,1.125,lavamanos
1594411990,1594413378,1388,0.12,0.01,lavaplatos
1594417005,1594417345,340,2.142857142857143,2.292,lavamanos
1594432727,1594432763,36,1.974,0.385,lavamanos
1594432791,1594432865,74,3.1182608695652174,3.81,ducha
1594447556,1594447916,360,0.72,4.319999999999999,inodoro
1594452307,1594452322,15,1.608,0.433,lavaplatos
1594452627,1594452987,360,0.72,4.319999999999999,inodoro
1594453312,1594453326,14,1.5085714285714285,0.381,lavamanos
1594461035,1594461050,15,0.8099999999999999,0.107,lavaplatos
1594467915,1594467981,66,1.1323809523809525,1.246,lavaplatos
1594468888,1594469463,575,1.8733333333333333,1.225,lavamanos
1594470607,1594470626,19,2.0066666666666664,0.682,lavamanos
1594472218,1594473742,1524,2.2432,4.773,lavaplatos
1594472896,1594473256,360,0.72,4.319999999999999,inodoro
1594473693,1594473694,1,0.4499999999999999,0.015,lavamanos
1594476015,1594476091,76,1.729090909090909,0.449,lavamanos
1594476015,1594477337,1322,0.74,17.526,ducha
1594476245,1594476263,18,2.1557142857142857,0.515,lavaplatos
1594480508,1594480517,9,1.2514285714285711,0.152,lavaplatos
1594481403,1594485023,3620,5.078709677419354,25.106,ducha
1594482381,1594482392,11,1.86,0.377,lavaplatos
1594482556,1594482601,45,2.572173913043478,1.079,lavamanos
1594483307,1594483353,46,2.4075,0.798,lavamanos
1594486131,1594487012,881,1.8473684210526315,3.336,lavaplatos
1594486314,1594486350,36,0.924,0.197,lavamanos
1594487694,1594487710,16,1.4325,0.413,lavamanos
1594488732,1594489092,360,0.72,4.319999999999999,inodoro
1594493607,1594494605,998,1.668,0.282,lavaplatos
1594497721,1594500160,2439,1.6178571428571429,6.918,lavaplatos
1594499905,1594500076,171,4.49245283018868,12.62,ducha
1594500577,1594500644,67,3.0631578947368423,2.115,lavamanos
1594510990,1594511031,41,1.2784615384615383,0.373,lavamanos
1594521265,1594521422,157,1.9125,3.435,lavamanos
1594540671,1594540687,16,1.48,0.245,lavaplatos
1594544178,1594544538,360,0.72,4.319999999999999,inodoro
1594545395,1594545440,45,2.106666666666667,0.788,lavaplatos
1594545573,1594545933,360,0.72,4.319999999999999,inodoro
1594547843,1594547844,1,0.72,0.024,lavamanos
1594549062,1594549103,41,2.335714285714286,0.639,lavamanos
1594551879,1594551904,25,1.944,0.244,lavamanos
1594552869,1594554045,1176,4.915076495132127,75.488,ducha
1594552944,1594553008,64,2.7688235294117645,1.729,lavamanos
1594554171,1594554595,424,3.846382978723404,3.334,lavamanos
1594559217,1594559577,360,0.72,4.319999999999999,inodoro
1594562350,1594562378,28,0.8925,0.399,lavamanos
1594564398,1594564532,134,2.19,0.68,lavamanos
1594567502,1594567613,111,2.5749152542372884,3.316,lavamanos
1594568432,1594568452,20,0.6375,0.111,lavamanos
1594569768,1594569818,50,2.968421052631579,1.067,lavamanos
1594571013,1594571264,251,2.9516129032258065,7.135,lavamanos
1594578773,1594579133,360,0.72,4.319999999999999,inodoro
1594591117,1594591678,561,0.800377358490566,1.362,lavamanos
1594591143,1594591143,1,0.78,0.013,lavaplatos
1594602794,1594602933,139,0.6575,0.692,lavamanos
1594623542,1594624333,791,1.4433333333333334,0.995,lavaplatos
1594627094,1594627287,193,2.0817391304347828,1.5,lavaplatos
1594629888,1594630248,360,0.72,4.319999999999999,inodoro
1594629967,1594630016,49,1.2876923076923077,0.366,lavamanos
1594633198,1594633200,2,2.4,0.12,lavaplatos
1594636416,1594636776,360,0.72,4.319999999999999,inodoro
1594636424,1594636461,37,1.285,0.348,lavamanos
1594638208,1594642328,4120,3.2180224719101123,76.563,lavaplatos
1594639645,1594639645,1,0.6599999999999999,0.011,lavamanos
1594641112,1594641472,360,0.72,4.319999999999999,inodoro
1594643273,1594643320,47,0.8952,0.49,lavamanos
1594643525,1594643885,360,0.72,4.319999999999999,inodoro
1594646299,1594647339,1040,4.1890909090909085,1.639,lavaplatos
1594649036,1594649396,360,0.72,4.319999999999999,inodoro
1594653211,1594653473,262,1.8866666666666665,1.566,lavaplatos
1594654365,1594654661,296,4.868014440433213,23.938,ducha
1594654415,1594655570,1155,3.4054054054054053,9.584,lavamanos
1594655518,1594655878,360,0.72,4.319999999999999,inodoro
1594666870,1594666923,53,1.8177777777777775,0.922,lavamanos
1594667183,1594671918,4735,2.6685,34.5,lavaplatos
1594670057,1594670417,360,0.72,4.319999999999999,inodoro
1594680983,1594681137,154,1.956,2.383,lavamanos
1594681952,1594682011,59,6.148235294117646,3.797,lavamanos
1594708325,1594708344,19,1.924,0.538,lavaplatos
1594708742,1594709409,667,2.129454545454545,2.313,lavamanos
1594715212,1594715572,360,0.72,4.319999999999999,inodoro
1594715741,1594716119,378,2.952142857142857,11.67,lavaplatos
1594716853,1594717213,360,0.72,4.319999999999999,inodoro
1594720287,1594722536,2249,2.4390697674418607,2.034,lavaplatos
1594724919,1594726693,1774,3.934761904761905,25.185,lavaplatos
1594727207,1594727242,35,1.5799999999999998,0.218,lavamanos
1594731672,1594732032,360,0.72,4.319999999999999,inodoro
1594731775,1594731839,64,2.5127272727272723,1.639,lavamanos
1594731916,1594732064,148,0.7875,0.387,lavaplatos
1594736326,1594736686,360,0.72,4.319999999999999,inodoro
1594738181,1594738256,75,1.866315789473684,1.724,lavaplatos
1594738469,1594738835,366,4.567250755287009,27.917,ducha
1594738527,1594739940,1413,2.7075,5.301,lavamanos
1594755655,1594755721,66,0.12,0.134,lavaplatos
1594758290,1594758539,249,4.479823008849557,18.538,ducha
1594758681,1594758793,112,4.156470588235294,3.946,lavamanos
1594833229,1594839805,6576,2.184590163934426,71.554,lavaplatos
1594833507,1594833549,42,1.575,0.699,lavamanos
1594835903,1594836263,360,0.72,4.319999999999999,inodoro
1594836632,1594836992,360,0.72,4.319999999999999,inodoro
1594837713,1594837732,19,2.055,0.298,lavamanos
1594841880,1594842240,360,0.72,4.319999999999999,inodoro
1594842653,1594843013,360,0.72,4.319999999999999,inodoro
1594843072,1594845644,2572,2.4008695652173917,13.31,lavaplatos
1594844856,1594845216,360,0.72,4.319999999999999,inodoro
1594846980,1594847000,20,0.5210526315789473,0.183,lavamanos
1594849525,1594851818,2293,2.359032258064516,12.682,lavaplatos
1594849925,1594850285,360,0.72,4.319999999999999,inodoro
1594852244,1594852257,13,0.8446153846153845,0.196,lavamanos
1594852996,1594853009,13,0.803076923076923,0.192,lavamanos
1594854053,1594854058,5,0.61,0.061,lavamanos
1594855248,1594855288,40,1.624736842105263,1.089,lavamanos
1594868986,1594869054,68,0.15,0.192,lavaplatos
1594880503,1594881243,740,1.9461290322580649,3.254,lavaplatos
1594883557,1594884090,533,2.19,1.24,lavamanos
1594885803,1594886665,862,2.5251612903225804,8.688,lavamanos
1594885861,1594886054,193,4.548447204968944,14.827,ducha
1594887142,1594887502,360,0.72,4.319999999999999,inodoro
1594887222,1594887236,14,0.41,0.059,lavaplatos
1594895332,1594895369,37,1.5,0.352,lavamanos
1594896713,1594896915,202,0.9729411764705882,2.461,lavaplatos
1594897465,1594897569,104,3.145116279069767,2.606,lavamanos
1594903750,1594903766,16,1.8642857142857143,0.445,lavamanos
1594904477,1594904752,275,1.509655172413793,11.835,lavamanos
1594905411,1594905676,265,2.8692,9.919,lavamanos
1594905628,1594905988,360,0.72,4.319999999999999,inodoro
1594907694,1594907779,85,2.948181818181818,3.013,lavaplatos
1594908643,1594908716,73,1.38,1.23,lavamanos
1594910121,1594910136,15,1.1,0.13,lavamanos
1594910184,1594910544,360,0.72,4.319999999999999,inodoro
1594912503,1594912644,141,3.784580152671756,8.819,ducha
1594912661,1594913021,360,0.72,4.319999999999999,inodoro
1594913254,1594913313,59,3.733846153846154,2.518,lavamanos
1594915988,1594916609,621,2.8564285714285718,8.414,lavamanos
1594943598,1594943968,370,1.8158490566037733,2.87,lavamanos
1594947780,1594947782,2,0.84,0.042,lavaplatos
1594947875,1594948688,813,3.292340425531915,3.419,lavamanos
1594968007,1594968367,360,0.72,4.319999999999999,inodoro
1594968152,1594968857,705,1.6414285714285717,0.387,lavaplatos
1594968855,1594968855,1,0.6599999999999999,0.011,lavamanos
1594969831,1594969865,34,2.401818181818182,1.403,lavamanos
1594971862,1594971926,64,2.243076923076923,1.056,lavaplatos
1594977064,1594977424,360,0.72,4.319999999999999,inodoro
1594977479,1594978799,1320,2.1243037974683543,20.486,lavaplatos
1594981413,1594981688,275,2.85,4.532,lavamanos
1594982877,1594982877,1,0.8999999999999999,0.015,lavamanos
1594985224,1594985253,29,1.332,0.175,lavamanos
1594985771,1594986131,360,0.72,4.319999999999999,inodoro
1594989572,1594989884,312,0.495,1.263,lavaplatos
1594989882,1594989915,33,1.98,0.254,lavamanos
1594992408,1594992430,22,1.4228571428571428,0.363,lavamanos
1594993297,1594993369,72,1.6849999999999998,1.383,lavamanos
1594993678,1594996229,2551,1.8276923076923075,18.042,lavaplatos
1594994290,1594994316,26,1.0099999999999998,0.143,lavamanos
1594995736,1594995748,12,2.6945454545454544,0.498,lavamanos
1594995779,1594996139,360,0.72,4.319999999999999,inodoro
1594999942,1595000412,470,5.314186046511628,8.922,ducha
1595000412,1595000952,540,2.706,1.474,lavamanos
1595001449,1595001669,220,2.772,1.387,lavaplatos
1595004086,1595004122,36,1.64,0.414,lavamanos
1595006620,1595006812,192,2.43,1.001,lavaplatos
1595008667,1595008921,254,1.788,0.487,lavamanos
1595016784,1595016801,17,0.69375,0.2,lavamanos
1595018474,1595019150,676,2.94,2.555,lavamanos
1595018533,1595019151,618,0.12,1.238,ducha
1595038717,1595038729,12,0.6,0.084,lavaplatos
1595038783,1595038825,42,0.912,0.224,lavamanos
1595063700,1595066835,3135,2.272682926829268,42.797,lavaplatos
1595065101,1595065461,360,0.72,4.319999999999999,inodoro
1595066600,1595066634,34,1.16,0.305,lavamanos
1595066750,1595067110,360,0.72,4.319999999999999,inodoro
1595069324,1595070339,1015,3.752920353982301,19.381,lavaplatos
1595070341,1595070701,360,0.72,4.319999999999999,inodoro
1595071191,1595071551,360,0.72,4.319999999999999,inodoro
1595072172,1595072172,1,0.36,0.006,lavamanos
1595072359,1595080972,8613,2.6749090909090905,89.296,lavaplatos
1595072847,1595072891,44,2.58,0.623,lavamanos
1595073137,1595073497,360,0.72,4.319999999999999,inodoro
1595077629,1595077666,37,1.56,0.371,lavamanos
1595083592,1595085144,1552,2.5146745562130177,18.106,lavamanos
1595085025,1595085385,360,0.72,4.319999999999999,inodoro
1595085455,1595085607,152,0.9923076923076924,0.709,lavaplatos
1595086126,1595086486,360,0.72,4.319999999999999,inodoro
1595087090,1595087116,26,3.2208,1.47,lavamanos
1595090119,1595090431,312,2.6746153846153846,1.277,lavamanos
1595090238,1595090598,360,0.72,4.319999999999999,inodoro
1595090322,1595090682,360,0.72,4.319999999999999,inodoro
1595092595,1595092955,360,0.72,4.319999999999999,inodoro
1595092801,1595092839,38,0.12,0.078,lavaplatos
1595093176,1595093187,11,2.5036363636363634,0.513,lavamanos
1595094111,1595094149,38,1.032857142857143,0.291,lavamanos
1595094774,1595094838,64,2.852307692307692,2.016,lavamanos
1595098625,1595098965,340,1.377,1.533,lavaplatos
1595102001,1595102361,360,0.72,4.319999999999999,inodoro
1595105187,1595105206,19,2.829473684210526,0.952,lavamanos
1595105766,1595106044,278,1.62,2.144,lavaplatos
1595105882,1595106242,360,0.72,4.319999999999999,inodoro
1595109271,1595109631,360,0.72,4.319999999999999,inodoro
1595126772,1595126774,2,0.8999999999999999,0.036,lavaplatos
1595128370,1595128517,147,1.7304545454545452,2.086,lavamanos
1595145320,1595145338,18,2.175,0.626,lavaplatos
1595145352,1595145712,360,0.72,4.319999999999999,inodoro
1595147226,1595147633,407,2.3974468085106384,4.97,lavamanos
1595147762,1595147783,21,2.85,1.008,lavaplatos
1595150983,1595151126,143,2.74359375,6.218,lavaplatos
1595152311,1595152671,360,0.72,4.319999999999999,inodoro
1595153579,1595153939,360,0.72,4.319999999999999,inodoro
1595154471,1595154484,13,3.31,0.731,lavaplatos
1595156083,1595156094,11,0.6,0.064,lavamanos
1595157191,1595160395,3204,2.6212244897959183,39.697,lavaplatos
1595160324,1595160345,21,0.576,0.082,lavamanos
1595162997,1595163206,209,3.5246153846153847,5.761,lavaplatos
1595163662,1595163686,24,1.56,0.453,lavamanos
1595167132,1595167222,90,1.808,0.71,lavamanos
1595167247,1595167607,360,0.72,4.319999999999999,inodoro
1595168994,1595169067,73,2.86375,2.573,lavamanos
1595169208,1595169218,10,4.398,0.883,lavaplatos
1595171812,1595171919,107,2.4892682926829264,3.571,lavaplatos
1595180074,1595180434,360,0.72,4.319999999999999,inodoro
1595183365,1595184174,809,1.7877966101694915,5.67,lavamanos
1595184258,1595184618,360,0.72,4.319999999999999,inodoro
1595196966,1595196978,12,1.157142857142857,0.151,lavaplatos
1595197780,1595197815,35,1.62,0.476,lavamanos
1595199619,1595199624,5,0.8,0.08,lavamanos
1595226659,1595227019,360,0.72,4.319999999999999,inodoro
1595227846,1595229328,1482,2.04,0.537,lavaplatos
1595230074,1595231418,1344,2.030061349693252,6.181,lavamanos
1595230144,1595230504,360,0.72,4.319999999999999,inodoro
1595233087,1595233093,6,0.6257142857142857,0.073,lavamanos
1595235693,1595235721,28,1.47,0.193,lavamanos
1595241245,1595241250,5,0.12,0.012,lavaplatos
1595244992,1595245007,15,0.765,0.122,lavamanos
1595252786,1595252788,2,1.88,0.094,lavaplatos
1595253073,1595253165,92,2.53695652173913,2.257,lavamanos
1595259692,1595259724,32,2.963076923076923,0.745,lavamanos
1595260401,1595260417,16,0.56,0.056,lavamanos
1595262549,1595263187,638,0.8999999999999999,0.236,lavaplatos
1595269149,1595269581,432,2.997,2.214,lavamanos
1595286192,1595286751,559,3.033962264150943,2.873,lavamanos
1595287085,1595288402,1317,3.218,1.948,lavaplatos
1595287389,1595287407,18,1.23,0.112,lavamanos
1595288499,1595288859,360,0.72,4.319999999999999,inodoro
1595296964,1595296975,11,0.15,0.026,lavaplatos
1595316252,1595316612,360,0.72,4.319999999999999,inodoro
1595316391,1595318273,1882,2.3907692307692305,1.728,lavaplatos
1595318102,1595318131,29,1.1528571428571428,0.326,lavamanos
1595318544,1595318904,360,0.72,4.319999999999999,inodoro
1595319462,1595319532,70,2.964,2.477,lavamanos
1595320239,1595320486,247,2.46,6.295,lavaplatos
1595320758,1595321048,290,1.962315789473684,6.613,lavamanos
1595321690,1595322050,360,0.72,4.319999999999999,inodoro
1595323362,1595323638,276,2.9841176470588238,4.431,lavaplatos
1595325986,1595325996,10,1.308,0.164,lavamanos
1595326084,1595326757,673,2.5625,1.088,lavaplatos
1595328233,1595328593,360,0.72,4.319999999999999,inodoro
1595330746,1595330769,23,2.4,0.366,lavamanos
1595330895,1595335405,4510,2.7909574468085108,78.055,lavaplatos
1595333594,1595333973,379,0.8079999999999999,0.303,lavamanos
1595337749,1595338159,410,2.4246153846153846,7.011,lavaplatos
1595338412,1595338426,14,1.877142857142857,0.471,lavamanos
1595338446,1595338806,360,0.72,4.319999999999999,inodoro
1595345693,1595346480,787,1.9639130434782608,7.531,lavamanos
1595347725,1595348095,370,3.255849056603773,3.108,lavamanos
1595349575,1595349601,26,0.1599999999999999,0.056,lavaplatos
1595361956,1595361975,19,0.7863157894736842,0.264,lavamanos
1595364247,1595364477,230,3.104516129032258,6.266,lavamanos
1595372405,1595372765,360,0.72,4.319999999999999,inodoro
1595380071,1595380151,80,1.2214285714285713,2.506,lavamanos
1595385034,1595385068,34,2.2909090909090906,0.55,lavamanos
1595403346,1595403372,26,2.02,0.472,lavamanos
1595403773,1595407528,3755,2.8028795811518323,39.052,lavaplatos
1595406870,1595407452,582,1.02,1.225,lavamanos
1595409742,1595409772,30,0.7114285714285714,0.161,lavamanos
1595411789,1595412149,360,0.72,4.319999999999999,inodoro
1595412953,1595413159,206,2.145,0.819,lavaplatos
1595415170,1595415329,159,1.8857142857142852,0.738,lavaplatos
1595420371,1595422142,1771,1.791864406779661,6.083,lavaplatos
1595420957,1595421317,360,0.72,4.319999999999999,inodoro
1595422501,1595422861,360,0.72,4.319999999999999,inodoro
1595423435,1595423475,40,2.2942857142857145,0.921,lavamanos
1595430357,1595430561,204,1.632,0.788,lavaplatos
1595433026,1595433055,29,4.317857142857142,2.171,lavamanos
1595434999,1595435797,798,1.5018749999999998,1.227,lavaplatos
1595436303,1595436319,16,0.6599999999999999,0.088,lavamanos
1595438460,1595438489,29,1.2733333333333332,0.269,lavamanos
1595445495,1595446223,728,0.5142857142857142,0.098,lavamanos
1595447223,1595447490,267,0.8,0.184,lavamanos
1595462041,1595462044,3,0.4499999999999999,0.023,lavaplatos
1595487496,1595489988,2492,2.119148936170213,5.188,lavaplatos
1595488921,1595489281,360,0.72,4.319999999999999,inodoro
1595492173,1595492737,564,1.5533333333333332,1.612,lavamanos
1595492812,1595492968,156,0.99,0.459,lavaplatos
1595494154,1595495081,927,3.1288888888888886,11.223,lavamanos
1595502604,1595502646,42,1.9342857142857144,0.757,lavamanos
1595502884,1595504970,2086,2.532162162162162,9.679,lavaplatos
1595503308,1595503337,29,3.156,0.315,lavamanos
1595504957,1595505172,215,2.3688,3.929,lavamanos
1595510195,1595510219,24,1.29,0.21,lavamanos
1595510919,1595510951,32,2.247272727272727,0.51,lavamanos
1595513748,1595514239,491,3.6498113207547167,3.467,lavamanos
1595514589,1595515826,1237,2.3936842105263154,0.874,lavaplatos
1595519223,1595519238,15,0.12,0.032,lavaplatos
1595520675,1595521035,360,0.72,4.319999999999999,inodoro
1595528672,1595529268,596,1.9741463414634148,1.528,lavamanos
1595528776,1595528940,164,3.2692499999999995,8.287,lavaplatos
1595531778,1595531829,51,2.6966666666666663,0.922,lavamanos
1595539635,1595540022,387,1.1888888888888889,0.618,lavamanos
1595540960,1595540960,1,0.54,0.009,lavamanos
1595541739,1595541919,180,0.24,0.008,lavamanos
1595542711,1595542711,1,0.54,0.009,lavamanos
1595544559,1595544559,1,0.6599999999999999,0.011,lavamanos
1595551038,1595551338,300,0.18,0.006,lavamanos
1595554228,1595554853,625,1.9008,0.858,lavamanos
1595554261,1595554621,360,0.72,4.319999999999999,inodoro
1595571340,1595571365,25,0.12,0.052,lavaplatos
1595575329,1595575445,116,2.247,2.948,lavaplatos
1595575522,1595576816,1294,2.5872361809045223,10.388,lavamanos
1595576451,1595576811,360,0.72,4.319999999999999,inodoro
1595577415,1595577775,360,0.72,4.319999999999999,inodoro
1595580660,1595580666,6,1.19,0.121,lavamanos
1595585049,1595585056,7,1.4657142857142855,0.175,lavamanos
1595587554,1595587672,118,1.605,2.041,lavamanos
1595593648,1595593691,43,2.3625,0.52,lavamanos
1595599461,1595599464,3,0.42,0.023,lavaplatos
1595600891,1595601432,541,0.18,0.006,lavamanos
1595602391,1595603674,1283,1.2763636363636364,0.634,lavamanos
1595603938,1595605378,1440,3.327142857142857,45.247,lavaplatos
1595605624,1595606520,896,2.65235294117647,4.282,lavamanos
1595607429,1595607961,532,1.1175,0.267,lavamanos
1595608178,1595608178,1,7.14,0.119,lavaplatos
1595629504,1595629785,281,2.22375,2.087,lavamanos
1595636267,1595636747,480,0.18,0.006,lavamanos
1595638427,1595638427,1,1.08,0.018,lavamanos
1595641745,1595641755,10,0.12,0.022,lavaplatos
1595643288,1595643768,480,1.5525,0.656,lavamanos
1595648329,1595648989,660,0.39,0.026,lavamanos
1595651929,1595651929,1,0.54,0.009,lavamanos
1595661114,1595661529,415,1.93125,0.599,lavamanos
1595661875,1595663205,1330,3.456774193548387,6.369,lavaplatos
1595663104,1595663281,177,2.052,1.817,lavamanos
1595663323,1595663683,360,0.72,4.319999999999999,inodoro
1595665136,1595665496,360,0.72,4.319999999999999,inodoro
1595665975,1595666090,115,1.153333333333333,0.551,lavamanos
1595666104,1595666130,26,1.434,0.68,lavaplatos
1595667218,1595667266,48,2.027441860465116,1.569,lavamanos
1595670080,1595670088,8,0.82,0.123,lavamanos
1595672477,1595672483,6,1.4,0.142,lavaplatos
1595672840,1595673035,195,0.9685714285714284,0.169,lavamanos
1595675033,1595675714,681,2.275588235294118,3.121,lavamanos
1595678150,1595681238,3088,2.0607,53.992,lavaplatos
1595680954,1595681314,360,0.72,4.319999999999999,inodoro
1595683866,1595684134,268,1.4917241379310344,1.571,lavamanos
1595684782,1595685234,452,0.8630769230769231,0.297,lavamanos
1595688898,1595688914,16,0.5538461538461538,0.164,lavamanos
1595690460,1595690696,236,1.086,3.179,lavamanos
1595696231,1595696281,50,1.2163636363636363,0.332,lavamanos
1595696425,1595696785,360,0.72,4.319999999999999,inodoro
1595696969,1595696999,30,2.3482758620689657,1.222,lavamanos
1595697844,1595698204,360,0.72,4.319999999999999,inodoro
1595707429,1595707434,5,4.656,0.39,lavaplatos
1595707720,1595708195,475,1.18,0.341,lavamanos
1595709278,1595709361,83,3.642127659574468,3.116,lavamanos
1595720209,1595720650,441,1.8103125,2.813,lavamanos
1595730210,1595730244,34,1.5525,0.261,lavamanos
1595734781,1595734781,1,0.36,0.006,lavamanos
1595741141,1595741141,1,0.54,0.009,lavamanos
1595741801,1595741801,1,0.36,0.006,lavamanos
1595745221,1595745221,1,0.78,0.013,lavamanos
1595745457,1595745560,103,0.12,0.208,lavaplatos
1595746060,1595746060,1,0.36,0.006,lavamanos
1595747801,1595747981,180,0.39,0.013,lavamanos
1595748058,1595749442,1384,2.379230769230769,1.961,lavaplatos
1595749121,1595750284,1163,1.1228571428571428,0.353,lavamanos
1595749430,1595749790,360,0.72,4.319999999999999,inodoro
1595751061,1595751118,57,1.861395348837209,1.486,lavamanos
1595751901,1595752061,160,2.136190476190476,3.498,lavamanos
1595752017,1595752377,360,0.72,4.319999999999999,inodoro
1595755955,1595756315,360,0.72,4.319999999999999,inodoro
1595756141,1595756141,1,0.54,0.009,lavamanos
1595761181,1595761186,5,0.47,0.047,lavamanos
1595764649,1595764657,8,0.3,0.042,lavamanos
1595767936,1595770566,2630,3.096774193548387,24.912,lavaplatos
1595768695,1595768725,30,1.0733333333333333,0.234,lavamanos
1595769765,1595769909,144,1.34625,1.411,lavamanos
1595772487,1595772967,480,0.18,0.006,lavamanos
1595779612,1595779612,1,0.6599999999999999,0.011,lavamanos
1595781722,1595781776,54,2.9864516129032257,1.694,lavamanos
1595784479,1595784486,7,0.3857142857142857,0.047,lavaplatos
1595784536,1595784543,7,0.8624999999999999,0.115,lavamanos
1595789184,1595789544,360,0.72,4.319999999999999,inodoro
1595789624,1595789901,277,1.3118181818181818,0.527,lavamanos
1595789796,1595790156,360,0.72,4.319999999999999,inodoro
1595808932,1595809081,149,1.187142857142857,2.044,lavamanos
1595833724,1595834084,360,0.72,4.319999999999999,inodoro
1595834738,1595836471,1733,2.808,1.725,lavaplatos
1595841651,1595844285,2634,2.601081081081081,16.211,lavaplatos
1595844626,1595844636,10,0.63,0.086,lavamanos
1595847331,1595847691,360,0.72,4.319999999999999,inodoro
1595849447,1595850907,1460,2.047407407407407,18.421,lavaplatos
1595850932,1595851244,312,2.6554838709677417,6.176,lavamanos
1595853339,1595853521,182,0.83,0.437,lavaplatos
1595855689,1595855948,259,1.6146,4.486,lavamanos
1595856866,1595856893,27,0.834,0.202,lavamanos
1595858549,1595858589,40,2.0025,0.398,lavamanos
1595861740,1595862390,650,2.6352631578947365,1.912,lavamanos
1595866917,1595867277,360,0.72,4.319999999999999,inodoro
1595869398,1595869425,27,0.864,0.18,lavamanos
1595869483,1595870733,1250,3.9461538461538463,1.784,lavaplatos
1595871495,1595871539,44,2.3157142857142854,1.705,lavamanos
1595873959,1595878447,4488,2.5099115044247786,31.524,lavaplatos
1595874497,1595874527,30,1.9725,0.355,lavamanos
1595875224,1595875248,24,0.85,0.353,lavamanos
1595877431,1595877632,201,5.04,3.618,lavamanos
1595881727,1595883447,1720,2.2842857142857143,3.01,lavaplatos
1595886344,1595886704,360,0.72,4.319999999999999,inodoro
1595892384,1595893035,651,2.496880733944954,11.86,lavaplatos
1595893047,1595893662,615,2.263795620437956,6.006,lavamanos
1595893098,1595893458,360,0.72,4.319999999999999,inodoro
1595895448,1595895927,479,3.28,31.633,lavaplatos
1595916772,1595917132,360,0.72,4.319999999999999,inodoro
1595921797,1595922056,259,2.7116129032258063,11.221,lavaplatos
1595924345,1595924407,62,2.778,2.038,lavaplatos
1595924583,1595924837,254,1.7474999999999998,0.299,lavamanos
1595924798,1595925158,360,0.72,4.319999999999999,inodoro
1595926256,1595926422,166,3.41126213592233,7.125,lavamanos
1595930725,1595931380,655,3.316981132075471,11.544,lavaplatos
1595932793,1595932830,37,1.1,0.229,lavamanos
1595936168,1595939249,3081,3.128333333333333,56.444,lavaplatos
1595939141,1595939324,183,3.495862068965517,6.072,lavamanos
1595939214,1595939574,360,0.72,4.319999999999999,inodoro
1595945224,1595946972,1748,2.648181818181818,1.022,lavaplatos
1595946269,1595946629,360,0.72,4.319999999999999,inodoro
1595947097,1595947199,102,1.326,1.687,lavamanos
1595949056,1595949063,7,0.7125,0.095,lavamanos
1595951320,1595951709,389,3.4888235294117647,8.481,lavamanos
1595951565,1595956243,4678,4.549140271493212,18.042,ducha
1595952331,1595952351,20,1.584,0.164,lavamanos
1595955134,1595955196,62,1.866315789473684,1.135,lavamanos
1595963271,1595963274,3,0.18,0.01,lavaplatos
1595974484,1595974502,18,1.716923076923077,0.578,lavamanos
1595976304,1595977927,1623,0.1599999999999999,0.014,lavaplatos
1595982942,1595983215,273,1.663333333333333,1.242,lavamanos
1596010570,1596010930,360,0.72,4.319999999999999,inodoro
1596012840,1596012844,4,0.588,0.049,lavamanos
1596021455,1596021577,122,1.9905882352941175,1.609,lavamanos
1596024120,1596024996,876,3.2237837837837837,35.775,lavaplatos
1596025157,1596025193,36,1.5199999999999998,0.386,lavamanos
1596028801,1596028801,1,0.36,0.006,lavamanos
1596032633,1596032638,5,5.91,0.712,lavaplatos
1596036210,1596036444,234,3.06,3.747,lavaplatos
1596036637,1596036954,317,5.689127516778523,30.02,ducha
1596037015,1596037076,61,4.144186046511628,3.235,lavamanos
1596040709,1596043404,2695,1.907142857142857,0.99,lavaplatos
1596042293,1596042455,162,5.1832,8.225,lavamanos
1596042920,1596043280,360,0.72,4.319999999999999,inodoro
1596043478,1596043541,63,3.6775,1.808,lavamanos
1596043541,1596043901,360,0.72,4.319999999999999,inodoro
1596044933,1596044991,58,4.323428571428572,2.729,lavamanos
1596045174,1596045534,360,0.72,4.319999999999999,inodoro
1596045458,1596045818,360,0.72,4.319999999999999,inodoro
1596046203,1596046964,761,2.301322314049586,8.245,lavamanos
1596046415,1596046612,197,4.595087719298245,15.267,ducha
1596047608,1596047640,32,2.1975,0.395,lavamanos
1596048236,1596048596,360,0.72,4.319999999999999,inodoro
1596054229,1596055650,1421,1.22,0.158,lavaplatos
1596054696,1596054736,40,1.0725,0.238,lavamanos
1596062261,1596062267,6,0.12,0.014,lavaplatos
1596068841,1596068859,18,1.1576470588235293,0.352,lavamanos
1596069894,1596069894,1,1.2,0.02,lavamanos
1596080018,1596080110,92,0.62,2.411,lavamanos
1596092187,1596094439,2252,1.5923076923076924,10.316,lavaplatos
1596093419,1596093779,360,0.72,4.319999999999999,inodoro
1596094006,1596094366,360,0.72,4.319999999999999,inodoro
1596094753,1596094808,55,1.5245454545454546,1.141,lavamanos
1596095693,1596096258,565,2.212941176470588,1.997,lavamanos
1596096148,1596096508,360,0.72,4.319999999999999,inodoro
1596096596,1596096616,20,2.4257142857142857,0.311,lavaplatos
1596103211,1596103315,104,1.4787096774193549,1.658,lavamanos
1596104563,1596110270,5707,2.584186046511628,27.476,lavaplatos
1596105091,1596105805,714,2.138,12.344,lavamanos
1596105783,1596106143,360,0.72,4.319999999999999,inodoro
1596106743,1596106832,89,1.7331147540983605,1.984,lavamanos
1596109922,1596110282,360,0.72,4.319999999999999,inodoro
1596110725,1596111085,360,0.72,4.319999999999999,inodoro
1596116623,1596116760,137,1.377142857142857,1.83,lavamanos
1596119824,1596120434,610,1.7686666666666666,3.005,lavamanos
1596122657,1596122699,42,1.632,0.414,lavamanos
1596133978,1596134364,386,0.78,0.229,lavamanos
1596138158,1596138169,11,1.750909090909091,0.354,lavamanos
1596138878,1596139109,231,4.94956937799043,19.014,ducha
1596138911,1596138991,80,3.9097297297297295,3.014,lavamanos
1596142526,1596143023,497,3.360618556701031,6.274,lavamanos
1596143024,1596143024,1,7.38,0.123,ducha
1596147206,1596147258,52,0.12,0.106,ducha
1596147350,1596147710,360,0.72,4.319999999999999,inodoro
1596152041,1596152141,100,2.733,4.545,lavaplatos
1596163779,1596167899,4120,0.12,2.176,ducha
1596171541,1596174778,3237,0.2599999999999999,0.913,ducha
1596174779,1596175346,567,0.18,0.006,lavamanos
1596175578,1596175938,360,0.72,4.319999999999999,inodoro
1596176036,1596176398,362,2.567142857142857,17.411,lavaplatos
1596176652,1596177194,542,2.3148,5.2,lavamanos
1596180507,1596180867,360,0.72,4.319999999999999,inodoro
1596180749,1596180793,44,1.05,0.272,lavamanos
1596182819,1596182829,10,1.89,0.317,lavamanos
1596183911,1596183956,45,1.832,0.558,lavamanos
1596185172,1596187485,2313,2.133529411764706,10.319,lavaplatos
1596190795,1596191155,360,0.72,4.319999999999999,inodoro
1596191507,1596191512,5,0.4559999999999999,0.04,lavamanos
1596192228,1596192417,189,1.9376470588235293,3.481,lavamanos
1596195598,1596195720,122,2.2875,1.148,lavamanos
1596196573,1596198029,1456,2.825,1.279,lavaplatos
1596197243,1596197255,12,1.4149999999999998,0.314,lavamanos
1596197892,1596198131,239,2.2745454545454544,0.465,lavamanos
1596201772,1596201805,33,1.89,0.382,lavamanos
1596202612,1596202781,169,2.4376,6.805,lavaplatos
1596204148,1596204508,360,0.72,4.319999999999999,inodoro
1596210196,1596210200,4,0.93,0.073,lavamanos
1596210643,1596210765,122,3.4305882352941177,3.359,lavaplatos
1596212708,1596212978,270,0.12,0.542,lavaplatos
1596226380,1596227098,718,1.6475,1.494,lavamanos
1596226485,1596226845,360,0.72,4.319999999999999,inodoro
1596227601,1596227618,17,1.056,0.114,lavaplatos
1596230964,1596230972,8,0.8066666666666666,0.121,lavamanos
1596231123,1596231230,107,3.7242,6.673,lavaplatos
1596248408,1596248451,43,1.703478260869565,0.729,lavamanos
1596261243,1596261603,360,0.72,4.319999999999999,inodoro
1596266724,1596269399,2675,2.178260869565217,37.273,lavaplatos
1596268017,1596268019,2,0.42,0.021,lavamanos
1596269143,1596269147,4,0.42,0.034,lavamanos
1596270008,1596270368,360,0.72,4.319999999999999,inodoro
1596270116,1596270208,92,1.6968,1.589,lavamanos
1596272183,1596272250,67,1.6572413793103449,0.933,lavamanos
1596274484,1596274490,6,0.6942857142857143,0.081,lavamanos
1596276142,1596276502,360,0.72,4.319999999999999,inodoro
1596278924,1596278957,33,1.5825,0.479,lavamanos
1596282403,1596284045,1642,3.21375,5.496,lavaplatos
1596284265,1596284625,360,0.72,4.319999999999999,inodoro
1596286367,1596286727,360,0.72,4.319999999999999,inodoro
1596286754,1596287114,360,0.72,4.319999999999999,inodoro
1596289232,1596289592,360,0.72,4.319999999999999,inodoro
1596290293,1596290653,360,0.72,4.319999999999999,inodoro
1596290924,1596291059,135,2.115405405405405,3.119,lavamanos
1596295501,1596295876,375,1.3575,0.698,lavamanos
1596295665,1596296755,1090,0.7919999999999999,1.372,lavaplatos
1596296197,1596296557,360,0.72,4.319999999999999,inodoro
1596296676,1596296795,119,4.406017699115044,8.884,ducha
1596297514,1596297592,78,2.822857142857143,2.144,lavamanos
1596303907,1596303954,47,1.9457142857142855,0.594,lavamanos
1596307083,1596307397,314,1.893333333333333,4.276,lavaplatos
1596310652,1596311012,360,0.72,4.319999999999999,inodoro
1596310785,1596311114,329,2.221875,1.327,lavamanos
1596318808,1596318808,1,0.54,0.009,lavamanos
1596321124,1596321484,360,0.72,4.319999999999999,inodoro
1596321476,1596321531,55,0.12,0.112,lavaplatos
1596336178,1596336211,33,2.493913043478261,1.027,lavamanos
1596337697,1596338003,306,1.2934426229508196,1.503,lavamanos
1596351917,1596355881,3964,3.2581967213114758,25.155,lavaplatos
1596352642,1596353286,644,1.7230366492146596,9.287,lavamanos
1596352701,1596353061,360,0.72,4.319999999999999,inodoro
1596354806,1596355284,478,2.707758620689656,7.9,lavamanos
1596356343,1596356406,63,1.908,0.762,lavamanos
1596356483,1596356843,360,0.72,4.319999999999999,inodoro
1596358142,1596359628,1486,2.202739726027397,6.23,lavaplatos
1596362019,1596362031,12,0.7854545454545455,0.148,lavaplatos
1596363719,1596364079,360,0.72,4.319999999999999,inodoro
1596364923,1596371446,6523,2.4156774193548385,53.797,lavaplatos
1596366812,1596367172,360,0.72,4.319999999999999,inodoro
1596366921,1596366928,7,1.3714285714285714,0.162,lavamanos
1596371480,1596371840,360,0.72,4.319999999999999,inodoro
1596372529,1596372583,54,1.9356521739130437,1.579,lavamanos
1596375688,1596375696,8,4.806666666666667,0.721,lavaplatos
1596378718,1596379078,360,0.72,4.319999999999999,inodoro
1596378922,1596378958,36,1.948,0.731,lavamanos
1596387541,1596387701,160,3.0442857142857145,8.114,lavaplatos
1596390097,1596390107,10,2.268,0.241,lavaplatos
1596394857,1596395107,250,1.930909090909091,4.074,lavaplatos
1596395268,1596395628,360,0.72,4.319999999999999,inodoro
1596399912,1596401492,1580,1.983302752293578,3.875,lavaplatos
1596400146,1596400385,239,2.038620689655172,7.388,lavamanos
1596400773,1596401133,360,0.72,4.319999999999999,inodoro
1596408013,1596408059,46,1.4142857142857144,0.423,lavamanos
1596417415,1596417420,5,4.25,0.425,lavaplatos
1596430556,1596430556,1,0.8999999999999999,0.015,lavamanos
1596436377,1596436377,1,0.78,0.013,lavamanos
1596437336,1596437657,321,2.053012048192771,3.104,lavamanos
1596438473,1596439578,1105,1.595,0.654,lavaplatos
1596439068,1596439428,360,0.72,4.319999999999999,inodoro
1596441119,1596441479,360,0.72,4.319999999999999,inodoro
1596441805,1596441820,15,3.588,0.966,lavaplatos
1596441904,1596442026,122,2.818125,4.849,lavamanos
1596442044,1596442251,207,4.733846153846153,16.454,ducha
1596443788,1596443803,15,2.044285714285714,0.521,lavamanos
1596443820,1596444180,360,0.72,4.319999999999999,inodoro
1596447953,1596448005,52,1.0371428571428571,0.213,lavamanos
1596450090,1596450288,198,3.1,0.368,lavamanos
1596453527,1596453887,360,0.72,4.319999999999999,inodoro
1596453946,1596454066,120,2.5,3.246,lavamanos
1596476063,1596476097,34,0.7328571428571428,0.226,lavamanos
1596481663,1596481667,4,0.12,0.01,lavaplatos
1596481782,1596482447,665,4.536180904522613,43.328,ducha
1596483360,1596483720,360,0.72,4.319999999999999,inodoro
1596494582,1596494593,11,0.78,0.156,lavamanos
1596494645,1596494843,198,2.64,2.948,lavaplatos
1596498393,1596498580,187,3.223846153846154,4.18,lavamanos
1596512088,1596512111,23,0.1599999999999999,0.05,lavaplatos
1596519656,1596519696,40,0.12,0.082,lavaplatos
1596520015,1596520552,537,1.778918918918919,3.879,lavamanos
1596525312,1596525672,360,0.72,4.319999999999999,inodoro
1596531078,1596531079,1,0.39,0.013,lavamanos
1596533335,1596533345,10,1.812,0.304,lavamanos
1596533542,1596533598,56,2.997446808510638,2.649,lavaplatos
1596536063,1596536162,99,2.346,2.985,lavaplatos
1596537102,1596537120,18,0.2249999999999999,0.045,lavamanos
1596539000,1596539200,200,2.181290322580645,4.177,lavamanos
1596539471,1596541564,2093,2.834845360824742,13.049,lavaplatos
1596541558,1596541918,360,0.72,4.319999999999999,inodoro
1596542261,1596542302,41,1.6309090909090909,0.361,lavamanos
1596544993,1596547263,2270,3.4288235294117646,2.258,lavaplatos
1596547158,1596547518,360,0.72,4.319999999999999,inodoro
1596547381,1596547741,360,0.72,4.319999999999999,inodoro
1596549165,1596549209,44,0.783157894736842,0.313,lavamanos
1596549319,1596551706,2387,2.136842105263158,5.521,lavaplatos
1596550300,1596551260,960,2.1514285714285712,2.508,lavamanos
1596552048,1596552380,332,1.982857142857143,0.711,lavamanos
1596554068,1596554089,21,3.10125,0.839,lavaplatos
1596556452,1596557404,952,1.6737499999999998,1.473,lavamanos
1596556742,1596557014,272,5.536062992125983,24.958,ducha
1596556980,1596560725,3745,2.716551724137931,35.863,lavaplatos
1596558111,1596558192,81,3.4136842105263154,2.546,lavamanos
1596559092,1596559106,14,1.11,0.277,lavamanos
1596560142,1596560158,16,0.7125,0.203,lavamanos
1596561029,1596561384,355,4.76065868263473,28.217,ducha
1596561101,1596561120,19,3.1357894736842105,1.051,lavamanos
1596561759,1596562444,685,0.6666666666666666,0.219,lavamanos
1596562214,1596562574,360,0.72,4.319999999999999,inodoro
1596592080,1596592093,13,1.210909090909091,0.289,lavamanos
1596592600,1596592960,360,0.72,4.319999999999999,inodoro
1596592696,1596592822,126,2.5712195121951216,4.431,lavamanos
1596612905,1596613503,598,1.905,0.759,lavaplatos
1596613620,1596613668,48,2.015675675675676,1.371,lavamanos
1596613727,1596614087,360,0.72,4.319999999999999,inodoro
1596618028,1596618270,242,3.262641509433962,5.41,lavaplatos
1596620558,1596620918,360,0.72,4.319999999999999,inodoro
1596621734,1596622094,360,0.72,4.319999999999999,inodoro
1596622336,1596622947,611,2.178260869565217,0.981,lavaplatos
1596623017,1596623560,543,1.210632911392405,2.859,lavamanos
1596628575,1596628935,360,0.72,4.319999999999999,inodoro
1596629655,1596629674,19,1.5218181818181815,0.326,lavamanos
1596630725,1596630904,179,2.648181818181818,13.76,lavaplatos
1596631547,1596631548,1,0.24,0.008,lavamanos
1596633737,1596636729,2992,1.3233333333333337,22.238,lavaplatos
1596633738,1596634315,577,0.12,0.238,lavamanos
1596640920,1596641280,360,0.72,4.319999999999999,inodoro
1596645228,1596645232,4,1.788,0.149,lavaplatos
1596645937,1596646548,611,1.176,0.445,lavamanos
1596646991,1596648158,1167,6.075355450236967,47.606,ducha
1596647171,1596647531,360,0.72,4.319999999999999,inodoro
1596647277,1596647886,609,2.7765217391304344,3.39,lavamanos
1596650074,1596650434,360,0.72,4.319999999999999,inodoro
1596652487,1596653617,1130,2.2271428571428573,4.943,lavaplatos
1596658905,1596658905,1,0.6599999999999999,0.011,lavamanos
1596676332,1596676342,10,0.7114285714285714,0.127,lavamanos
1596694447,1596694807,360,0.72,4.319999999999999,inodoro
1596697257,1596699030,1773,1.7916666666666663,4.038,lavaplatos
1596698816,1596699176,360,0.72,4.319999999999999,inodoro
1596698831,1596698845,14,1.665,0.37,lavamanos
1596703623,1596703983,360,0.72,4.319999999999999,inodoro
1596703639,1596703671,32,0.735,0.107,lavamanos
1596704862,1596705222,360,0.72,4.319999999999999,inodoro
1596705544,1596706022,478,0.6927272727272726,1.063,lavaplatos
1596708625,1596708985,360,0.72,4.319999999999999,inodoro
1596708635,1596708660,25,2.157391304347826,0.873,lavamanos
1596709020,1596709388,368,1.0875,0.996,lavaplatos
1596713294,1596715541,2247,2.673898305084746,31.029,lavaplatos
1596714628,1596714661,33,1.5857142857142856,0.637,lavamanos
1596715556,1596715592,36,2.02875,0.623,lavamanos
1596718718,1596719078,360,0.72,4.319999999999999,inodoro
1596720018,1596720021,3,1.42,0.075,lavamanos
1596723143,1596723596,453,4.747728337236534,35.883,ducha
1596723896,1596723955,59,2.594117647058823,1.612,lavamanos
1596731606,1596731966,360,0.72,4.319999999999999,inodoro
1596736707,1596736903,196,5.595272727272727,18.395,ducha
1596736730,1596737624,894,2.537704918032787,2.83,lavamanos
1596736846,1596737317,471,0.15,0.946,lavaplatos
1596757222,1596757240,18,0.9685714285714284,0.254,lavamanos
1596757871,1596758231,360,0.72,4.319999999999999,inodoro
1596761754,1596761794,40,1.056,0.16,lavamanos
1596764406,1596764594,188,1.5453061224489797,3.222,lavamanos
1596781871,1596783295,1424,2.8004999999999995,11.501,lavaplatos
1596782630,1596782990,360,0.72,4.319999999999999,inodoro
1596788464,1596793061,4597,2.660913705583756,38.636,lavaplatos
1596789073,1596789433,360,0.72,4.319999999999999,inodoro
1596793114,1596793240,126,2.722702702702702,5.843,lavamanos
1596794002,1596794013,11,1.7639999999999998,0.161,lavamanos
1596797113,1596797259,146,1.416774193548387,1.56,lavaplatos
1596797406,1596797661,255,4.91673640167364,20.88,ducha
1596797455,1596798205,750,2.489032258064516,2.832,lavamanos
1596797707,1596798067,360,0.72,4.319999999999999,inodoro
1596799411,1596799413,2,0.3199999999999999,0.016,lavamanos
1596804779,1596804851,72,1.2839999999999998,0.509,lavamanos
1596810189,1596810192,3,0.615,0.041,lavamanos
1596810273,1596812266,1993,4.875026269702277,49.345,ducha
1596811664,1596811739,75,2.7061224489795914,2.585,lavamanos
1596829597,1596829638,41,1.3114285714285714,0.362,lavamanos
1596829775,1596829875,100,4.981978021978022,8.091,lavaplatos
1596831138,1596831138,1,0.36,0.006,lavamanos
1596848586,1596848946,360,0.72,4.319999999999999,inodoro
1596853595,1596853955,360,0.72,4.319999999999999,inodoro
1596859767,1596859846,79,0.12,0.16,lavaplatos
1596868451,1596868497,46,1.737142857142857,0.694,lavamanos
1596868507,1596868867,360,0.72,4.319999999999999,inodoro
1596870620,1596873549,2929,2.8083870967741933,8.787,lavaplatos
1596871379,1596871416,37,1.152,0.279,lavamanos
1596871629,1596871989,360,0.72,4.319999999999999,inodoro
1596872436,1596872478,42,1.4257142857142855,0.577,lavamanos
1596873655,1596873702,47,1.91625,0.615,lavamanos
1596876904,1596876911,7,0.92,0.116,lavamanos
1596877437,1596877797,360,0.72,4.319999999999999,inodoro
1596877512,1596877560,48,1.909090909090909,0.788,lavamanos
1596880127,1596880736,609,2.4416216216216218,5.553,lavamanos
1596880589,1596881120,531,6.899876543209876,60.682,ducha
1596881807,1596881838,31,1.56,0.388,lavamanos
1596882896,1596882900,4,0.564,0.047,lavamanos
1596883633,1596883993,360,0.72,4.319999999999999,inodoro
1596886085,1596886088,3,0.69,0.046,lavamanos
1596893823,1596893826,3,0.18,0.01,lavaplatos
1596893880,1596893913,33,0.84,0.128,lavamanos
1596893919,1596894279,360,0.72,4.319999999999999,inodoro
1596895202,1596895221,19,0.8466666666666666,0.275,lavamanos
1596898277,1596898309,32,0.96,0.122,lavamanos
1596901003,1596901047,44,1.16,0.268,lavamanos
1596904099,1596904106,7,0.525,0.043,lavaplatos
1596904420,1596905335,915,14.768165680473372,90.035,ducha
1596905183,1596905543,360,0.72,4.319999999999999,inodoro
1596905193,1596905553,360,0.72,4.319999999999999,inodoro
1596905725,1596905787,62,2.7252631578947364,1.917,lavamanos
1596909790,1596909830,40,0.87,0.273,lavamanos
1596912045,1596912547,502,1.05,4.236,lavaplatos
1596913651,1596913665,14,1.062857142857143,0.266,lavamanos
1596919820,1596919826,6,2.2,0.269,lavaplatos
1596942955,1596943155,200,2.248125,1.312,lavamanos
1596958156,1596958516,360,0.72,4.319999999999999,inodoro
1596958564,1596958924,360,0.72,4.319999999999999,inodoro
1596959060,1596959420,360,0.72,4.319999999999999,inodoro
1596959178,1596959309,131,3.1269565217391304,4.03,lavamanos
1596960049,1596960090,41,1.2218181818181817,0.288,lavamanos
1596961149,1596961827,678,2.43495145631068,5.49,lavamanos
1596963288,1596963368,80,1.2176470588235293,0.541,lavamanos
1596966073,1596966112,39,2.262857142857143,0.332,lavamanos
1596974689,1596975178,489,2.2937142857142856,1.547,lavamanos
1596975188,1596975432,244,2.2745454545454544,2.06,lavaplatos
1596978973,1596979002,29,2.6424,1.189,lavamanos
1596979736,1596979788,52,2.6242105263157893,0.969,lavaplatos
1596983700,1596984060,360,0.72,4.319999999999999,inodoro
1596983917,1596983953,36,2.511428571428571,0.632,lavaplatos
1596989867,1596989874,7,3.214285714285714,0.435,lavaplatos
1596991406,1596991766,360,0.72,4.319999999999999,inodoro
1596991745,1596994510,2765,4.113687707641196,30.267,lavaplatos
1596992694,1596992703,9,1.06,0.067,lavamanos
1596993644,1596996672,3028,12.992477064220182,91.324,ducha
1596994843,1596994925,82,2.7685714285714287,3.444,lavamanos
1596995796,1596995856,60,3.2335135135135133,2.154,lavamanos
1596996432,1596996578,146,1.478181818181818,1.195,lavaplatos
1596997037,1596997103,66,1.9605,1.559,lavamanos
1596997229,1596997589,360,0.72,4.319999999999999,inodoro
1597026709,1597027637,928,0.1599999999999999,0.012,lavaplatos
1597175108,1597175358,250,4.6657142857142855,18.611,lavaplatos
1597175179,1597176517,1338,0.2,1.264,ducha
1597175192,1597175192,1,0.6599999999999999,0.011,lavamanos
1597175801,1597175842,41,5.592631578947368,1.932,lavamanos
1597178174,1597178186,12,4.055,0.903,lavamanos
1597178317,1597178322,5,3.66,0.366,lavaplatos
1597182722,1597182784,62,2.9841176470588238,2.542,lavamanos
1597183194,1597183554,360,0.72,4.319999999999999,inodoro
1597190180,1597192891,2711,7.561379310344827,16.357,lavaplatos
1597190182,1597190182,1,0.78,0.013,lavamanos
1597192421,1597192738,317,4.015714285714286,2.292,lavamanos
1597262974,1597263138,164,0.1333333333333333,0.332,lavaplatos
1597328452,1597328489,37,10.778709677419355,6.953,lavaplatos
1597328742,1597328771,29,2.6066666666666665,0.514,lavamanos
1597379680,1597380029,349,0.1371428571428571,0.702,lavaplatos
1597584209,1597584240,31,2.64,3.846,lavaplatos
1597584464,1597584498,34,6.565714285714286,1.898,lavamanos
1597616359,1597616833,474,0.12,0.95,lavaplatos
1597761530,1597761538,8,1.0666666666666669,0.16,lavamanos
1597762685,1597763045,360,0.72,4.319999999999999,inodoro
1597762719,1597762759,40,2.272173913043478,0.979,lavamanos
1597763126,1597763486,360,0.72,4.319999999999999,inodoro
1597763530,1597763589,59,7.6431578947368415,7.656,ducha
1597765955,1597765979,24,2.394,0.929,lavaplatos
1597774903,1597774916,13,1.7123076923076923,0.373,lavamanos
1597774932,1597778882,3950,3.3590721649484534,28.438,lavaplatos
1597781051,1597781083,32,1.8733333333333333,0.337,lavamanos
1597782445,1597782451,6,1.44,0.146,lavaplatos
1597790291,1597790651,360,0.72,4.319999999999999,inodoro
1597797960,1597798101,141,0.144,0.286,lavaplatos
1597801194,1597801194,1,1.98,0.033,lavamanos
1597801194,1597801194,1,0.6599999999999999,0.011,lavaplatos
1597816555,1597822274,5719,4.210344827586207,9.611,lavaplatos
1597817323,1597817683,360,0.72,4.319999999999999,inodoro
1597817449,1597817809,360,0.72,4.319999999999999,inodoro
1597817599,1597817790,191,1.9209523809523807,2.648,lavamanos
1597817698,1597818058,360,0.72,4.319999999999999,inodoro
1597817874,1597821031,3157,7.279599999999999,38.679,ducha
1597820270,1597820275,5,0.57,0.057,lavamanos
1597821704,1597821730,26,2.16,0.292,lavamanos
1597824436,1597824474,38,2.692,1.047,lavamanos
1597825146,1597825213,67,4.012727272727273,2.49,lavamanos
1597867398,1597867721,323,0.14,0.65,lavaplatos
1597879036,1597879051,15,6.496,1.743,lavaplatos
1597882498,1597882840,342,2.31219512195122,6.617,lavamanos
1597904687,1597904765,78,6.605999999999999,3.522,lavaplatos
1597915756,1597915789,33,5.844374999999999,3.321,lavaplatos
1597916477,1597916511,34,5.475,1.028,lavamanos
1597916561,1597916671,110,6.15,11.376,ducha
1597918597,1597918801,204,3.1706493506493505,8.789,lavaplatos
1597919176,1597919201,25,1.1314285714285717,0.17,lavamanos
1597942918,1597943144,226,6.579130434782609,19.48,lavaplatos
1597943097,1597943100,3,0.825,0.055,lavamanos
1597947150,1597948817,1667,6.207272727272727,2.428,lavaplatos
1597951410,1597951488,78,3.622702702702703,2.545,lavamanos
1597956816,1597960571,3755,5.562068965517241,9.064,lavaplatos
1597959661,1597960618,957,0.585,14.995,ducha
1597959661,1597959931,270,0.2,0.022,lavamanos
1597960569,1597960837,268,0.8999999999999999,0.818,lavamanos
1597968777,1597980716,11939,0.4636363636363636,23.653,ducha
1597974536,1597974536,1,0.54,0.009,lavamanos
1597975497,1597975497,1,0.36,0.006,lavamanos
1597978797,1597979097,300,0.4499999999999999,0.015,lavamanos
1597979756,1597979756,1,1.62,0.027,lavamanos
1597980716,1597980716,1,0.36,0.006,lavamanos
1597985096,1597993795,8699,0.3857142857142857,4.597,ducha
1597985368,1597985485,117,0.12,0.236,lavaplatos
1597986475,1597986475,1,0.54,0.009,lavamanos
1597991515,1597991995,480,0.24,0.008,lavamanos
1597993278,1597993826,548,4.782,4.263,lavaplatos
1597997953,1597997996,43,5.0175,3.618,lavaplatos
1597999495,1597999675,180,0.3299999999999999,0.011,lavamanos
1598001277,1598001781,504,2.5473684210526315,2.615,lavamanos
1598025693,1598025708,15,7.925000000000001,2.215,lavaplatos
1598025734,1598026204,470,3.0989189189189186,2.154,lavamanos
1598025785,1598025893,108,7.044117647058823,12.81,ducha
1598060826,1598061061,235,6.722950819672131,21.647,lavaplatos
1598061262,1598061384,122,1.7084210526315788,1.575,lavamanos
1598082286,1598082872,586,5.036842105263157,3.413,lavaplatos
1598087591,1598087620,29,5.7092307692307696,2.603,lavaplatos
1598091840,1598091854,14,5.267142857142857,1.334,lavaplatos
1598092052,1598092083,31,2.4428571428571426,0.335,lavamanos
1598093028,1598093044,16,0.596,0.171,lavamanos
1598093879,1598094189,310,1.1781818181818182,0.703,lavamanos
1598097149,1598097352,203,5.597727272727273,10.474,lavaplatos
1598112691,1598114931,2240,4.122105263157895,6.526,lavaplatos
1598113997,1598114163,166,0.3299999999999999,0.011,lavamanos
1598114794,1598114835,41,4.36,1.693,lavamanos
1598149561,1598149597,36,8.097692307692308,3.827,lavaplatos
1598151860,1598151937,77,4.284489795918367,3.783,lavamanos
1598175430,1598175468,38,7.244571428571429,4.524,lavaplatos
1598217663,1598220103,2440,4.263130434782608,13.939,lavaplatos
1598218700,1598218707,7,3.78,0.443,lavamanos
1598223112,1598223370,258,0.6942857142857143,0.083,lavamanos
1598238490,1598238730,240,0.18,0.006,lavamanos
1598242811,1598243290,479,0.24,0.008,lavamanos
1598255932,1598257098,1166,4.731932773109244,12.191,lavaplatos
1598257055,1598257257,202,3.587058823529412,10.974,lavamanos
1598274821,1598274855,34,3.084375,1.718,lavaplatos
1598278579,1598278588,9,0.12,0.02,lavaplatos
1598278885,1598278893,8,1.3575,0.183,lavamanos
1598281243,1598281249,6,0.8099999999999999,0.085,lavamanos
1598310227,1598310232,5,0.58,0.058,lavamanos
1598323081,1598323320,239,0.3,0.01,lavamanos
1598325720,1598326201,481,0.18,0.006,lavamanos
1598330279,1598330279,1,0.6599999999999999,0.011,lavamanos
1598334599,1598334599,1,1.08,0.018,lavamanos
1598343491,1598343491,1,0.54,0.009,lavamanos
1598343562,1598343568,6,1.33,0.135,lavaplatos
1598347125,1598347202,77,2.6844827586206894,3.291,lavamanos
1598350524,1598350845,321,1.5646478873239438,9.698,lavaplatos
1598351775,1598351812,37,1.296,0.174,lavamanos
1598357211,1598357579,368,0.12,0.738,lavaplatos
1598396866,1598397163,297,6.067826086956522,38.959,lavaplatos
1598397413,1598397420,7,1.575,0.21,lavamanos
1598426156,1598426744,588,0.78,2.546,lavaplatos
1598427093,1598427099,6,0.5485714285714285,0.064,lavamanos
1598429725,1598429938,213,2.593246753246753,4.34,lavaplatos
1598432774,1598433503,729,3.67,7.407,lavaplatos
1598439660,1598439854,194,1.4228571428571428,0.206,lavamanos
1598440711,1598440748,37,1.266,0.296,lavamanos
1598441908,1598441937,29,3.465,1.47,lavaplatos
1598448087,1598448545,458,2.3463157894736844,2.416,lavaplatos
1598448249,1598448312,63,1.44,1.164,lavamanos
1598451420,1598451438,18,1.0439999999999998,0.341,lavamanos
1598451527,1598451887,360,0.72,4.319999999999999,inodoro
1598456327,1598465801,9474,2.3981385729058946,162.793,lavaplatos
1598459074,1598459098,24,1.3025,0.548,lavamanos
1598466801,1598467032,231,2.7109090909090905,7.538,lavamanos
1598467916,1598467998,82,1.9516363636363636,1.942,lavamanos
1598471168,1598471244,76,3.7369565217391294,3.132,lavamanos
1598472136,1598472156,20,3.321,1.172,lavamanos
1598473260,1598479798,6538,2.525853658536585,27.134,lavaplatos
1598475458,1598475524,66,2.156170212765957,1.837,lavamanos
1598475643,1598476003,360,0.72,4.319999999999999,inodoro
1598476537,1598476580,43,0.9260869565217392,0.413,lavamanos
1598477685,1598477700,15,0.8614285714285714,0.218,lavamanos
1598480076,1598480629,553,0.9293023255813954,1.674,lavamanos
1598480475,1598480835,360,0.72,4.319999999999999,inodoro
1598493246,1598493253,7,1.3199999999999998,0.156,lavamanos
1598506569,1598506929,360,0.72,4.319999999999999,inodoro
1598506763,1598509593,2830,1.962142857142857,7.078,lavaplatos
1598507811,1598507827,16,0.6675,0.189,lavamanos
1598509477,1598509860,383,1.6732394366197183,2.138,lavamanos
1598509640,1598509870,230,4.133055555555555,15.79,ducha
1598511179,1598511200,21,0.606,0.224,lavamanos
1598511278,1598511638,360,0.72,4.319999999999999,inodoro
1598517276,1598517636,360,0.72,4.319999999999999,inodoro
1598517479,1598517803,324,0.6224999999999999,0.717,lavaplatos
1598517502,1598517639,137,1.8313043478260869,2.71,lavamanos
1598525963,1598526323,360,0.72,4.319999999999999,inodoro
1598525975,1598525976,1,0.51,0.017,lavamanos
1598525994,1598527667,1673,2.687619047619047,3.762,lavaplatos
1598527885,1598528245,360,0.72,4.319999999999999,inodoro
1598528630,1598528990,360,0.72,4.319999999999999,inodoro
1598533854,1598534035,181,3.009333333333333,2.707,lavaplatos
1598538020,1598538055,35,2.087142857142857,0.611,lavamanos
1598538737,1598538845,108,3.652941176470588,6.629,ducha
1598538935,1598539295,360,0.72,4.319999999999999,inodoro
1598538958,1598539036,78,3.502173913043478,3.297,lavamanos
1598541091,1598541341,250,2.34375,3.033,lavaplatos
1598541670,1598541743,73,2.1165217391304347,2.581,lavamanos
1598544427,1598544463,36,1.6842857142857144,0.47,lavamanos
1598545689,1598547363,1674,2.5730434782608693,6.362,lavaplatos
1598546586,1598546624,38,1.7172413793103447,0.879,lavamanos
1598546617,1598547099,482,4.807633928571428,38.682,ducha
1598547462,1598547510,48,2.558181818181818,0.545,lavamanos
1598549450,1598549466,16,0.87,0.25,lavamanos
1598550419,1598550779,360,0.72,4.319999999999999,inodoro
1598550641,1598550787,146,0.7274999999999999,2.877,lavamanos
1598573367,1598573382,15,0.8185714285714285,0.221,lavamanos
1598576946,1598576951,5,5.569999999999999,0.557,lavaplatos
1598577783,1598577939,156,0.5305882352941177,1.231,lavamanos
1598579234,1598579238,4,0.12,0.01,lavaplatos
1598590611,1598590734,123,0.12,0.248,lavaplatos
1598596680,1598597040,360,0.72,4.319999999999999,inodoro
1598598029,1598600433,2404,2.1270329670329677,11.284,lavaplatos
1598598376,1598598429,53,2.68,2.426,lavamanos
1598599958,1598600111,153,1.33875,2.207,lavamanos
1598601407,1598601767,360,0.72,4.319999999999999,inodoro
1598603056,1598603100,44,0.9975,0.207,lavamanos
1598604921,1598605135,214,3.0923684210526314,5.983,lavaplatos
1598605007,1598605367,360,0.72,4.319999999999999,inodoro
1598605289,1598605326,37,1.3384615384615384,0.44,lavamanos
1598608654,1598608662,8,0.7274999999999999,0.11,lavamanos
1598608681,1598609041,360,0.72,4.319999999999999,inodoro
1598608880,1598608893,13,4.024285714285714,0.939,lavaplatos
1598609642,1598609658,16,0.495,0.059,lavamanos
1598612922,1598614757,1835,2.758021978021978,5.176,lavaplatos
1598615121,1598615481,360,0.72,4.319999999999999,inodoro
1598620839,1598620873,34,1.8981818181818184,0.466,lavamanos
1598621764,1598621802,38,2.2575,0.517,lavamanos
1598625400,1598625760,360,0.72,4.319999999999999,inodoro
1598625426,1598625505,79,1.6402702702702705,2.172,ducha
1598625590,1598627147,1557,2.071304347826086,3.069,lavaplatos
1598626320,1598626395,75,5.6365384615384615,5.232,lavamanos
1598631945,1598632492,547,2.094782608695652,1.9,lavaplatos
1598636782,1598639966,3184,2.5995652173913046,3.462,lavaplatos
1598639403,1598639763,360,0.72,4.319999999999999,inodoro
1598663713,1598663940,227,0.12,0.456,lavaplatos
1598666852,1598666859,7,5.434285714285714,0.757,lavaplatos
1598666978,1598666990,12,0.7363636363636363,0.161,lavamanos
1598684829,1598685395,566,1.694,1.105,lavaplatos
1598684928,1598685209,281,1.5941772151898734,3.174,lavamanos
1598685587,1598685947,360,0.72,4.319999999999999,inodoro
1598689004,1598689364,360,0.72,4.319999999999999,inodoro
1598693230,1598693247,17,2.215,0.455,lavaplatos
1598695764,1598695774,10,1.02,0.112,lavaplatos
1598696430,1598696790,360,0.72,4.319999999999999,inodoro
1598696495,1598696495,1,0.54,0.009,lavamanos
1598697474,1598697505,31,1.2666666666666666,0.236,lavamanos
1598699518,1598700097,579,2.28,1.075,lavamanos
1598699564,1598700901,1337,4.127205882352941,37.622,lavaplatos
1598703570,1598703882,312,2.047142857142857,12.021,lavaplatos
1598707732,1598707767,35,0.7707692307692308,0.274,lavamanos
1598709615,1598709662,47,2.7430434782608697,2.193,lavaplatos
1598709730,1598710090,360,0.72,4.319999999999999,inodoro
1598712310,1598712331,21,1.7,0.626,lavaplatos
1598716620,1598716636,16,2.0485714285714285,0.484,lavaplatos
1598720762,1598722135,1373,3.691794871794872,16.607,lavaplatos
1598723377,1598723435,58,1.387741935483871,0.818,lavamanos
1598723663,1598724023,360,0.72,4.319999999999999,inodoro
1598733605,1598734827,1222,5.44,1.481,lavaplatos
1598733920,1598735594,1674,3.172372881355932,8.05,ducha
1598734903,1598735595,692,3.357303370786517,7.003,lavamanos
1598744590,1598744726,136,0.12,0.274,ducha
1598744658,1598745018,360,0.72,4.319999999999999,inodoro
1598744700,1598744748,48,2.4312,1.235,lavamanos
1598750340,1598750406,66,0.12,0.134,lavaplatos
1598754975,1598755025,50,7.971249999999999,6.849,lavaplatos
1598771900,1598772136,236,1.823283582089552,3.582,lavaplatos
1598772689,1598773049,360,0.72,4.319999999999999,inodoro
1598772789,1598772879,90,2.6545454545454543,3.369,lavamanos
1598774717,1598774721,4,2.175,0.147,lavamanos
1598779089,1598779123,34,1.5342857142857145,0.4,lavamanos
1598781391,1598781407,16,1.722,0.301,lavaplatos
1598782824,1598783184,360,0.72,4.319999999999999,inodoro
1598782935,1598782971,36,2.1685714285714286,0.597,lavamanos
1598789002,1598789459,457,1.690909090909091,1.204,lavaplatos
1598794280,1598796791,2511,2.3719047619047617,15.299,lavaplatos
1598797544,1598797904,360,0.72,4.319999999999999,inodoro
1598797572,1598797602,30,2.715,0.5,lavamanos
1598803674,1598803743,69,1.612258064516129,1.069,lavamanos
1598803827,1598805920,2093,5.630569476082004,63.826,ducha
1598805941,1598806007,66,2.3857894736842105,1.816,lavamanos
1598824934,1598825638,704,1.1720000000000002,2.145,lavamanos
1598825430,1598825576,146,1.817142857142857,2.224,lavaplatos
1598834407,1598834423,16,1.3628571428571428,0.179,lavamanos
1598858387,1598859650,1263,1.5461538461538462,1.049,lavaplatos
1598858543,1598858543,1,0.54,0.009,lavamanos
1598862539,1598862548,9,1.7742857142857142,0.267,lavaplatos
1598865005,1598865429,424,1.7127272727272729,2.665,lavaplatos
1598865686,1598866046,360,0.72,4.319999999999999,inodoro
1598866849,1598867278,429,2.81575221238938,6.551,lavamanos
1598876618,1598876978,360,0.72,4.319999999999999,inodoro
1598876669,1598876682,13,1.46,0.327,lavamanos
1598881055,1598881415,360,0.72,4.319999999999999,inodoro
1598887185,1598888249,1064,1.508,4.529,lavaplatos
1598890386,1598891066,680,4.26,1.279,lavaplatos
1598895987,1598896497,510,3.1302857142857143,11.229,lavaplatos
1598899806,1598901594,1788,2.0171134020618555,7.619,lavaplatos
1598913081,1598913481,400,0.12,0.802,lavaplatos
1598914360,1598914720,360,0.72,4.319999999999999,inodoro
1598915817,1598915925,108,0.6548275862068965,0.815,lavamanos
1598945007,1598945566,559,1.77,0.566,lavaplatos
1598945278,1598945619,341,2.607906976744186,4.018,lavamanos
1598945498,1598945858,360,0.72,4.319999999999999,inodoro
1598946152,1598946512,360,0.72,4.319999999999999,inodoro
1598951272,1598951371,99,3.58,3.849,lavamanos
1598951601,1598951616,15,3.736,1.001,lavaplatos
1598957100,1598957119,19,0.9221052631578948,0.307,lavamanos
1598957277,1598958204,927,2.090561797752809,6.555,lavaplatos
1598958266,1598958294,28,1.305,0.297,lavamanos
1598958929,1598958961,32,0.6342857142857142,0.126,lavamanos
1598959015,1598959375,360,0.72,4.319999999999999,inodoro
1598962155,1598962194,39,2.412,0.271,lavamanos
1598964599,1598965126,527,4.665882352941177,2.749,lavamanos
1598964750,1598964879,129,4.919016393442623,10.631,ducha
1598965303,1598965336,33,3.57,1.992,lavaplatos
1598972421,1598972436,15,1.65,0.185,lavaplatos
1598972794,1598972817,23,1.1154545454545453,0.44,lavamanos
1598980237,1598980379,142,2.017894736842105,1.695,lavamanos
1598981435,1598982100,665,2.989959183673469,20.217,lavaplatos
1598985887,1598985912,25,0.63,0.164,lavaplatos
1598985964,1598986324,360,0.72,4.319999999999999,inodoro
1598993366,1598993705,339,1.5811267605633803,2.511,lavaplatos
1598995927,1598995955,28,1.69125,0.477,lavaplatos
1599009176,1599009186,10,4.002,0.671,lavaplatos
1599015076,1599015327,251,0.12,0.504,lavaplatos
1599032603,1599032963,360,0.72,4.319999999999999,inodoro
1599033692,1599033697,5,1.296,0.135,lavaplatos
1599034406,1599034766,360,0.72,4.319999999999999,inodoro
1599034568,1599034587,19,1.095,0.134,lavamanos
1599036781,1599036781,1,0.6599999999999999,0.011,lavaplatos
1599039972,1599039972,1,4.14,0.069,lavaplatos
1599042275,1599042275,1,1.44,0.024,lavaplatos
1599043922,1599043942,20,1.5211764705882351,0.502,lavamanos
1599046276,1599046636,360,0.72,4.319999999999999,inodoro
1599046503,1599046547,44,3.0572093023255813,2.298,lavaplatos
1599046521,1599046550,29,1.6418181818181818,0.348,lavamanos
1599048947,1599051039,2092,3.735,13.116,lavaplatos
1599050585,1599050657,72,2.761875,1.915,lavamanos
1599053404,1599053454,50,1.2799999999999998,1.092,ducha
1599057996,1599058000,4,2.196,0.183,lavaplatos
1599061951,1599062311,360,0.72,4.319999999999999,inodoro
1599064364,1599064413,49,4.515652173913043,3.786,lavaplatos
1599069947,1599070030,83,2.2043478260869565,2.922,lavaplatos
1599071758,1599072118,360,0.72,4.319999999999999,inodoro
1599072503,1599072582,79,1.452972972972973,2.298,lavamanos
1599072541,1599075587,3046,5.422342342342342,31.97,ducha
1599073325,1599073358,33,2.6266666666666665,0.446,lavamanos
1599088854,1599088869,15,2.875,0.749,lavamanos
1599089002,1599089362,360,0.72,4.319999999999999,inodoro
1599092412,1599092825,413,7.107391304347826,11.711,lavaplatos
1599102825,1599103050,225,0.12,0.452,lavaplatos
1599115207,1599115791,584,1.2046153846153846,1.405,lavaplatos
1599118086,1599121859,3773,2.9511462450592885,16.939,lavaplatos
1599120619,1599120634,15,1.704,0.166,lavamanos
1599121949,1599122309,360,0.72,4.319999999999999,inodoro
1599123723,1599123729,6,1.74,0.203,lavaplatos
1599125528,1599125888,360,0.72,4.319999999999999,inodoro
1599125830,1599125846,16,1.7657142857142856,0.454,lavaplatos
1599127334,1599127459,125,3.1588235294117646,3.094,lavamanos
1599132546,1599135501,2955,2.5602197802197804,14.741,lavaplatos
1599137907,1599138444,537,1.212,2.372,lavaplatos
1599138363,1599138379,16,1.283076923076923,0.33,lavamanos
1599140324,1599141015,691,2.4688888888888885,3.045,lavamanos
1599140450,1599141103,653,4.798407079646017,34.348,ducha
1599141827,1599141902,75,3.3405405405405406,2.343,lavamanos
1599141975,1599142335,360,0.72,4.319999999999999,inodoro
1599156385,1599156396,11,1.7618181818181815,0.361,lavamanos
1599157481,1599158036,555,2.582307692307692,2.231,lavaplatos
1599169786,1599170146,360,0.72,4.319999999999999,inodoro
1599183002,1599183030,28,2.795555555555556,1.352,lavaplatos
1599185036,1599185100,64,2.385263157894737,2.412,lavamanos
1599191928,1599192073,145,0.12,0.292,lavaplatos
1599198918,1599199307,389,1.255384615384615,1.026,lavaplatos
1599199211,1599199398,187,2.4779220779220776,5.716,lavamanos
1599209935,1599209997,62,9.27103448275862,9.631,lavaplatos
1599216528,1599216590,62,2.1375,1.831,lavamanos
1599217671,1599217684,13,0.6276923076923077,0.147,lavamanos
1599217760,1599217792,32,3.3225,1.475,lavaplatos
1599219421,1599219459,38,0.7366666666666667,0.276,lavamanos
1599221432,1599221778,346,2.1946875,3.196,lavaplatos
1599222752,1599223112,360,0.72,4.319999999999999,inodoro
1599234729,1599235007,278,4.284761904761905,9.403,lavaplatos
1599238907,1599242338,3431,5.784196185286104,38.66,ducha
1599239177,1599239204,27,0.24,0.112,lavamanos
1599239566,1599241133,1567,2.6266019417475728,13.503,lavaplatos
1599241048,1599241070,22,0.87,0.237,lavamanos
1599246640,1599247000,360,0.72,4.319999999999999,inodoro
1599252388,1599252457,69,2.805333333333333,2.299,lavamanos
1599254737,1599254963,226,0.12,0.454,lavaplatos
1599256546,1599256906,360,0.72,4.319999999999999,inodoro
1599274343,1599274355,12,5.652,0.948,lavaplatos
1599281476,1599281555,79,0.12,0.16,lavaplatos
1599289472,1599289832,360,0.72,4.319999999999999,inodoro
1599290423,1599292341,1918,2.1385185185185183,14.687,lavaplatos
1599290924,1599291549,625,2.8785365853658536,4.192,lavamanos
1599293081,1599293441,360,0.72,4.319999999999999,inodoro
1599295572,1599295578,6,2.56,0.316,lavaplatos
1599295901,1599296040,139,1.7474999999999998,2.495,lavamanos
1599295965,1599296325,360,0.72,4.319999999999999,inodoro
1599297973,1599297997,24,2.91,1.215,lavaplatos
1599300847,1599301207,360,0.72,4.319999999999999,inodoro
1599305115,1599305183,68,1.889333333333333,1.6,lavamanos
1599305909,1599312137,6228,3.912647058823529,25.086,lavaplatos
1599313127,1599313308,181,2.6393258426966293,4.542,lavamanos
1599314372,1599314452,80,3.445352112676056,4.684,ducha
1599314399,1599314881,482,2.76,0.092,lavaplatos
1599315090,1599315157,67,3.78734693877551,3.327,lavamanos
1599319841,1599321521,1680,2.556,2.354,lavaplatos
1599319863,1599320026,163,2.386530612244898,2.309,lavamanos
1599319929,1599320289,360,0.72,4.319999999999999,inodoro
1599320941,1599321519,578,2.0957142857142856,5.185,lavamanos
1599325677,1599326726,1049,1.83625,1.619,lavaplatos
1599331639,1599331671,32,1.4577777777777778,0.743,lavaplatos
1599331824,1599332184,360,0.72,4.319999999999999,inodoro
1599338772,1599339132,360,0.72,4.319999999999999,inodoro
1599339158,1599339206,48,2.464285714285714,1.278,lavamanos
1599342971,1599343010,39,1.27125,0.481,lavamanos
1599359073,1599359936,863,5.142295081967212,6.208,lavaplatos
1599359221,1599359581,360,0.72,4.319999999999999,inodoro
1599359597,1599359633,36,1.3984615384615384,0.38,lavamanos
1599373884,1599377161,3277,2.186384778012685,33.72,lavaplatos
1599374697,1599374731,34,1.5,0.343,lavamanos
1599375838,1599375925,87,2.721492537313433,3.304,lavamanos
1599375941,1599376209,268,4.338480000000001,19.36,ducha
1599376264,1599376624,360,0.72,4.319999999999999,inodoro
1599377700,1599378060,360,0.72,4.319999999999999,inodoro
1599377726,1599377927,201,2.7111627906976743,3.79,lavamanos
1599378260,1599378620,360,0.72,4.319999999999999,inodoro
1599383036,1599383036,1,9.0,0.15,ducha
1599383037,1599383037,1,9.3,0.155,lavamanos
1599567268,1599567282,14,0.9814285714285714,0.251,lavamanos
1599568310,1599568670,360,0.72,4.319999999999999,inodoro
1599568500,1599569087,587,3.3040000000000003,1.799,lavaplatos
1599571333,1599571344,11,2.2963636363636364,0.466,lavaplatos
1599572940,1599574385,1445,5.6066666666666665,21.322,ducha
1599574150,1599574161,11,3.096,0.587,lavamanos
1599577167,1599577214,47,0.12,0.096,lavaplatos
1599579517,1599579654,137,5.15088,11.646,ducha
1599584529,1599584544,15,1.7679999999999998,0.48,lavamanos
1599586124,1599586598,474,6.386428571428572,10.502,lavaplatos
1599589762,1599590563,801,1.826086956521739,1.131,lavaplatos
1599593084,1599593127,43,4.119512195121951,3.032,lavamanos
1599593238,1599593598,360,0.72,4.319999999999999,inodoro
1599596931,1599596982,51,0.12,0.104,lavaplatos
1599608424,1599608438,14,1.4030769230769229,0.335,lavamanos
1599608641,1599608794,153,2.024516129032258,3.264,lavaplatos
1599608864,1599609224,360,0.72,4.319999999999999,inodoro
1599613763,1599613859,96,0.12,0.194,lavaplatos
1599631571,1599631961,390,1.475,1.1,lavaplatos
1599632662,1599632810,148,2.072857142857143,4.763,lavamanos
1599633822,1599634182,360,0.72,4.319999999999999,inodoro
1599634644,1599634656,12,0.636,0.069,lavaplatos
1599635312,1599635672,360,0.72,4.319999999999999,inodoro
1599637450,1599637455,5,4.815,0.325,lavaplatos
1599637545,1599640542,2997,5.34099173553719,37.261,ducha
1599637816,1599638121,305,0.24,0.118,lavamanos
1599638989,1599639656,667,4.172941176470588,4.23,lavamanos
1599639475,1599639643,168,0.23,0.349,lavaplatos
1599640412,1599640577,165,0.3553846153846154,1.144,lavamanos
1599655711,1599655718,7,0.12,0.016,lavaplatos
1599688747,1599688764,17,2.79,0.858,lavamanos
1599688821,1599689181,360,0.72,4.319999999999999,inodoro
1599688907,1599689304,397,4.703684210526316,17.499,lavaplatos
1599689137,1599690373,1236,4.643508771929824,16.576,ducha
1599689481,1599689841,360,0.72,4.319999999999999,inodoro
1599691982,1599692065,83,3.842608695652173,3.288,lavamanos
1599704171,1599704240,69,0.1599999999999999,0.27,lavaplatos
1599716179,1599716375,196,4.066516853932584,13.298,ducha
1599716206,1599716256,50,4.146521739130434,3.543,lavamanos
1599719910,1599720160,250,5.5487179487179485,11.876,lavaplatos
1599730352,1599730354,2,0.3799999999999999,0.019,lavamanos
1599731229,1599731265,36,2.612727272727273,0.587,lavamanos
1599734001,1599734034,33,0.1599999999999999,0.072,lavaplatos
1599736419,1599737024,605,2.561052631578947,4.468,lavaplatos
1599737064,1599737097,33,0.768,0.122,lavamanos
1599745485,1599745496,11,4.546666666666666,0.786,lavamanos
1599745954,1599746314,360,0.72,4.319999999999999,inodoro
1599746228,1599747393,1165,4.756521739130434,25.637,lavaplatos
1599747087,1599747117,30,1.9028571428571428,0.328,lavamanos
1599748005,1599748431,426,5.051644204851752,35.823,ducha
1599748146,1599748225,79,0.24,0.32,lavamanos
1599748830,1599748890,60,3.445161290322581,2.047,lavamanos
1599749253,1599750133,880,4.46,0.733,lavaplatos
1599754122,1599754130,8,0.14,0.02,lavaplatos
1599759362,1599759405,43,0.12,0.088,lavaplatos
1599775964,1599776326,362,1.575,1.019,lavaplatos
1599776056,1599776095,39,1.5085714285714285,0.485,lavamanos
1599781031,1599781109,78,4.367999999999999,5.405,lavaplatos
1599788138,1599788166,28,1.302857142857143,0.23,lavamanos
1599796735,1599796759,24,0.12,0.05,lavaplatos
1599800800,1599801160,360,0.72,4.319999999999999,inodoro
1599806835,1599806993,158,2.919473684210526,8.233,lavaplatos
1599808768,1599808834,66,2.113846153846154,1.629,lavamanos
1599808839,1599808991,152,4.621714285714285,11.716,ducha
1599810194,1599810235,41,0.6399999999999999,0.136,lavamanos
1599816018,1599816161,143,2.363333333333333,2.552,lavamanos
1599821203,1599821237,34,1.674,0.365,lavamanos
1599821726,1599822572,846,3.243,1.152,lavaplatos
1599825016,1599827147,2131,3.40125,7.901,lavaplatos
1599827002,1599827048,46,2.4927272727272727,0.587,lavamanos
1599827997,1599828357,360,0.72,4.319999999999999,inodoro
1599830570,1599830579,9,1.5066666666666666,0.262,lavamanos
1599831342,1599831357,15,1.41,0.317,lavamanos
1599835755,1599836106,351,4.803738317757009,28.013,ducha
1599836675,1599836715,40,1.5672727272727272,1.096,lavamanos
1599838090,1599838099,9,0.12,0.02,lavaplatos
1599843274,1599843634,360,0.72,4.319999999999999,inodoro
1599851798,1599851845,47,3.4546666666666663,2.765,lavaplatos
1599857612,1599857624,12,0.18,0.028,lavaplatos
1599860361,1599860366,5,0.15,0.014,lavaplatos
1599893435,1599894203,768,2.745,4.659,lavaplatos
1599895608,1599895613,5,0.56,0.034,lavamanos
1599895669,1599896029,360,0.72,4.319999999999999,inodoro
1599896034,1599896367,333,2.900816326530612,19.087,lavaplatos
1599899200,1599899239,39,2.34,0.376,lavamanos
1599900860,1599901377,517,1.8922222222222225,5.966,lavamanos
1599900915,1599901275,360,0.72,4.319999999999999,inodoro
1599904846,1599910002,5156,2.132201834862385,50.476,lavaplatos
1599907904,1599907943,39,1.4466666666666663,0.344,lavamanos
1599908862,1599909222,360,0.72,4.319999999999999,inodoro
1599909779,1599909792,13,0.905,0.203,lavamanos
1599914725,1599915280,555,1.4785714285714284,1.469,lavaplatos
1599920930,1599921521,591,1.908,1.482,lavaplatos
1599921155,1599921181,26,1.9848,0.901,lavamanos
1599925161,1599925206,45,0.99,0.371,lavamanos
1599926721,1599926736,15,1.892,0.509,lavamanos
1599927902,1599928297,395,4.7670080862533695,31.511,ducha
1599934054,1599934414,360,0.72,4.319999999999999,inodoro
1599934350,1599936683,2333,2.5940506329113924,11.265,lavaplatos
1599937743,1599937957,214,4.183030303030304,14.793,ducha
1599937766,1599938587,821,2.438095238095238,3.214,lavamanos
1599944803,1599945020,217,2.911970802919708,8.652,lavamanos
1599945041,1599945054,13,4.901538461538461,1.154,lavaplatos
1599949213,1599949247,34,0.8649999999999999,0.295,lavamanos
1599949286,1599949646,360,0.72,4.319999999999999,inodoro
1599952696,1599952724,28,0.12,0.058,lavaplatos
1599955384,1599955439,55,0.12,0.112,lavaplatos
1599966496,1599966856,360,0.72,4.319999999999999,inodoro
1599966583,1599966639,56,2.808,1.064,lavamanos
1599980731,1599981008,277,2.126153846153846,3.57,lavaplatos
1599981115,1599981373,258,2.725135135135135,6.806,lavamanos
1599983486,1599983580,94,2.207586206896552,1.773,lavaplatos
1599986133,1599986161,28,0.9369230769230767,0.282,lavaplatos
1599986164,1599986181,17,1.432,0.364,lavamanos
1599988629,1599988681,52,2.2288888888888887,1.131,lavamanos
1599988654,1599989389,735,0.4499999999999999,2.951,ducha
1599989343,1599989703,360,0.72,4.319999999999999,inodoro
1599991705,1599992065,360,0.72,4.319999999999999,inodoro
1599991741,1599991775,34,1.9242857142857144,0.529,lavamanos
1599994382,1599997069,2687,2.831454545454545,50.235,lavaplatos
1599994454,1599994462,8,0.4499999999999999,0.029,lavamanos
1600002908,1600003059,151,2.063333333333333,4.224,lavamanos
1600013190,1600013473,283,1.712,1.011,lavaplatos
1600014092,1600014397,305,3.012295081967213,10.55,ducha
1600014719,1600014807,88,3.529523809523809,4.756,lavamanos
1600016177,1600016537,360,0.72,4.319999999999999,inodoro
1600016775,1600016782,7,3.27,0.436,lavaplatos
1600022861,1600022890,29,0.12,0.06,lavaplatos
1600028049,1600028250,201,0.12,0.404,ducha
1600065685,1600066045,360,0.72,4.319999999999999,inodoro
1600069777,1600070137,360,0.72,4.319999999999999,inodoro
1600080850,1600081210,360,0.72,4.319999999999999,inodoro
1600102320,1600102320,1,1.2,0.02,lavaplatos
1600102553,1600104024,1471,2.7705882352941176,4.456,ducha
1600102571,1600102594,23,0.34,0.059,lavamanos
1600107135,1600107143,8,1.665,0.159,lavaplatos
1600115709,1600116069,360,0.72,4.319999999999999,inodoro
1600147718,1600148824,1106,3.1066666666666665,0.47,lavaplatos
1600149263,1600149623,360,0.72,4.319999999999999,inodoro
1600149328,1600149392,64,3.3331034482758617,1.821,lavamanos
1600152363,1600152698,335,1.5,2.441,lavaplatos
1600156191,1600156229,38,1.7123076923076923,0.469,lavamanos
1600156260,1600156620,360,0.72,4.319999999999999,inodoro
1600157125,1600157130,5,0.6399999999999999,0.064,lavamanos
1600158499,1600158859,360,0.72,4.319999999999999,inodoro
1600161108,1600161468,360,0.72,4.319999999999999,inodoro
1600163234,1600163316,82,2.664155844155844,3.697,lavamanos
1600163339,1600163492,153,4.699999999999999,12.024,ducha
1600164197,1600167856,3659,2.6723076923076925,76.364,lavaplatos
1600169382,1600169742,360,0.72,4.319999999999999,inodoro
1600171615,1600172660,1045,3.196153846153846,7.468,lavaplatos
1600172324,1600172366,42,2.175,0.497,lavamanos
1600173671,1600173972,301,4.85469964664311,24.482,ducha
1600173832,1600173962,130,0.2,0.368,lavamanos
1600175115,1600175173,58,2.304,1.508,lavamanos
1600178215,1600179733,1518,1.3,0.144,lavaplatos
1600180800,1600180800,1,0.54,0.009,lavamanos
1600182387,1600183141,754,2.31375,15.479,lavaplatos
1600182718,1600183078,360,0.72,4.319999999999999,inodoro
1600183675,1600183695,20,2.135294117647059,0.759,lavamanos
1600192675,1600198097,5422,2.98601226993865,24.021,lavaplatos
1600194104,1600194134,30,1.94,0.426,lavamanos
1600207461,1600207489,28,0.8066666666666666,0.391,lavamanos
1600207718,1600207739,21,3.309,1.17,lavaplatos
1600212244,1600212500,256,0.12,0.514,lavaplatos
1600214746,1600215106,360,0.72,4.319999999999999,inodoro
1600238336,1600239656,1320,2.494838709677419,9.802,lavaplatos
1600239626,1600239986,360,0.72,4.319999999999999,inodoro
1600240133,1600240168,35,2.135294117647059,0.726,lavamanos
1600246094,1600246288,194,2.30625,4.548,lavamanos
1600248178,1600248210,32,1.692,0.493,lavamanos
1600250506,1600250520,14,2.476363636363636,0.622,lavaplatos
1600250625,1600250671,46,2.415,0.634,lavamanos
1600252499,1600252859,360,0.72,4.319999999999999,inodoro
1600253572,1600256832,3260,2.227674418604651,16.451,lavaplatos
1600258084,1600258098,14,2.181428571428571,0.556,lavamanos
1600259598,1600261639,2041,3.852931034482759,11.72,lavaplatos
1600260126,1600260186,60,3.142758620689655,3.202,lavamanos
1600260283,1600260643,360,0.72,4.319999999999999,inodoro
1600260525,1600260885,360,0.72,4.319999999999999,inodoro
1600260957,1600261110,153,3.086341463414634,5.432,lavamanos
1600262654,1600263503,849,2.2966153846153845,2.732,lavamanos
1600262787,1600264467,1680,4.303410852713179,34.853,ducha
1600264116,1600264476,360,0.72,4.319999999999999,inodoro
1600264450,1600265526,1076,3.453658536585366,2.542,lavamanos
1600275877,1600275906,29,0.12,0.06,lavaplatos
1600283178,1600283193,15,1.684,0.454,lavamanos
1600283577,1600284587,1010,2.463076923076923,3.424,lavaplatos
1600289857,1600290296,439,9.15,64.253,lavaplatos
1600291288,1600291328,40,0.78,0.306,lavamanos
1600299009,1600299084,75,0.12,0.152,lavaplatos
1600303014,1600303479,465,0.2,1.486,ducha
1600303014,1600303479,465,0.1599999999999999,0.008,lavamanos
1600303034,1600303046,12,4.575,0.971,lavaplatos
1600310664,1600310818,154,0.12,0.31,lavaplatos
1600326338,1600328328,1990,2.9879999999999995,10.482,lavaplatos
1600326698,1600327058,360,0.72,4.319999999999999,inodoro
1600326747,1600326755,8,1.3457142857142856,0.161,lavamanos
1600333477,1600333483,6,0.62,0.039,lavaplatos
1600333573,1600333623,50,6.939130434782609,5.742,ducha
1600334202,1600334562,360,0.72,4.319999999999999,inodoro
1600335429,1600335451,22,3.488181818181818,1.346,lavaplatos
1600337254,1600337278,24,0.7725,0.322,lavamanos
1600338030,1600338058,28,1.0542857142857145,0.205,lavamanos
1600338297,1600343581,5284,3.077957746478873,45.56,lavaplatos
1600339543,1600339592,49,3.4584615384615383,2.45,lavamanos
1600342706,1600342708,2,0.57,0.025,lavamanos
1600344642,1600344684,42,1.2799999999999998,0.26,lavamanos
1600352890,1600355425,2535,5.418510638297873,36.24,ducha
1600353087,1600356112,3025,1.8521052631578947,4.194,lavaplatos
1600353455,1600353491,36,3.5629411764705883,2.153,lavamanos
1600354658,1600356178,1520,2.1566197183098588,3.646,lavamanos
1600355514,1600355874,360,0.72,4.319999999999999,inodoro
1600357281,1600357285,4,0.72,0.069,lavamanos
1600380859,1600380985,126,1.21875,1.71,lavamanos
1600382063,1600382098,35,0.9276923076923076,0.263,lavamanos
1600382115,1600382183,68,4.527096774193549,5.002,lavaplatos
1600383453,1600383813,360,0.72,4.319999999999999,inodoro
1600383464,1600383489,25,0.9109090909090908,0.388,lavamanos
1600393828,1600393861,33,0.864,0.192,lavamanos
1600397461,1600397861,400,0.12,0.802,lavaplatos
1600408441,1600410765,2324,2.266229508196721,15.492,lavaplatos
1600409634,1600409966,332,1.7271028037383178,4.546,lavamanos
1600410913,1600411273,360,0.72,4.319999999999999,inodoro
1600412557,1600412568,11,2.064,0.391,lavamanos
1600413050,1600413469,419,6.087,2.912,lavaplatos
1600424994,1600425064,70,0.12,0.142,lavaplatos
1600429221,1600429265,44,3.222,0.607,lavamanos
1600430598,1600430630,32,1.3114285714285714,0.205,lavamanos
1600431521,1600431555,34,1.224,0.162,lavamanos
1600439029,1600439065,36,4.897714285714286,3.031,lavaplatos
1600439603,1600439937,334,5.808659793814432,32.348,ducha
1600439712,1600439922,210,0.2,0.114,lavamanos
1600441090,1600441141,51,2.997777777777777,1.505,lavamanos
1600450375,1600450451,76,0.12,0.154,lavaplatos
1600467527,1600467535,8,2.43,0.378,lavaplatos
1600467560,1600467593,33,0.7949999999999999,0.214,lavamanos
1600468401,1600468761,360,0.72,4.319999999999999,inodoro
1600477960,1600478118,158,0.12,0.318,lavaplatos
1600483768,1600484128,360,0.72,4.319999999999999,inodoro
1600483844,1600483939,95,3.3370212765957445,3.154,lavamanos
1600500650,1600501668,1018,2.692682926829268,30.936,lavaplatos
1600501181,1600501194,13,0.834,0.16,lavamanos
1600502477,1600503088,611,1.8184615384615384,0.936,lavamanos
1600503634,1600503994,360,0.72,4.319999999999999,inodoro
1600503912,1600504408,496,6.64,86.516,lavaplatos
1600513753,1600514182,429,2.16,9.759,lavaplatos
1600516087,1600517091,1004,2.895882352941177,4.287,lavaplatos
1600519371,1600519382,11,2.787272727272727,0.567,lavaplatos
1600524591,1600524951,360,0.72,4.319999999999999,inodoro
1600525152,1600525656,504,3.063380281690141,8.306,lavaplatos
1600525725,1600525753,28,1.8257142857142856,0.306,lavamanos
1600527704,1600527742,38,1.4788235294117646,0.574,lavamanos
1600527926,1600528049,123,1.3658823529411763,1.723,lavaplatos
1600532189,1600534521,2332,4.01328,29.866,lavaplatos
1600532226,1600532258,32,1.7861538461538462,0.458,lavamanos
1600535409,1600535769,360,0.72,4.319999999999999,inodoro
1600535420,1600535456,36,1.5985714285714283,0.492,lavamanos
1600539964,1600540004,40,2.15625,0.67,lavamanos
1600540230,1600542864,2634,2.466645569620253,26.413,lavaplatos
1600545730,1600546354,624,2.816504854368932,7.941,lavamanos
1600545790,1600546327,537,5.872594142259414,52.489,ducha
1600550147,1600550875,728,2.6369491525423725,3.06,lavamanos
1600550728,1600551047,319,1.9125,1.448,lavaplatos
1600556331,1600556345,14,0.7457142857142857,0.189,lavamanos
1600556716,1600557261,545,4.972363636363636,5.843,lavaplatos
1600556809,1600557169,360,0.72,4.319999999999999,inodoro
1600584666,1600584666,1,0.54,0.009,lavamanos
1600586239,1600586631,392,2.325,4.131,lavaplatos
1600586551,1600586593,42,0.7666666666666667,0.291,lavamanos
1600586835,1600587195,360,0.72,4.319999999999999,inodoro
1600588893,1600589920,1027,1.21,2.274,lavaplatos
1600592080,1600592440,360,0.72,4.319999999999999,inodoro
1600592147,1600592147,1,0.8999999999999999,0.015,lavamanos
1600593272,1600593632,360,0.72,4.319999999999999,inodoro
1600595576,1600595862,286,1.310769230769231,1.493,lavaplatos
1600597680,1600602732,5052,2.234306049822064,39.954,lavaplatos
1600600580,1600600603,23,1.3114285714285714,0.212,lavamanos
1600601362,1600601378,16,0.7537499999999999,0.214,lavamanos
1600606977,1600607046,69,2.9716666666666667,1.964,lavamanos
1600609940,1600610300,360,0.72,4.319999999999999,inodoro
1600610685,1600611251,566,1.1292857142857142,5.364,lavaplatos
1600610848,1600610887,39,1.49625,0.476,lavamanos
1600611553,1600612762,1209,1.7123076923076923,0.435,lavamanos
1600613643,1600613643,1,0.54,0.009,lavamanos
1600619387,1600620469,1082,5.382960725075529,40.928,ducha
1600619740,1600620324,584,2.350769230769231,1.697,lavamanos
1600626673,1600627218,545,1.914782608695652,0.798,lavaplatos
1600630807,1600631167,360,0.72,4.319999999999999,inodoro
1600639805,1600639835,30,0.8571428571428572,0.166,lavamanos
1600644503,1600644863,360,0.72,4.319999999999999,inodoro
1600645469,1600649555,4086,0.12,1.304,ducha
1600667200,1600667221,21,0.1542857142857143,0.05,lavaplatos
1600672704,1600676035,3331,1.83,8.14,lavaplatos
1600673313,1600673341,28,0.708,0.107,lavamanos
1600674798,1600675158,360,0.72,4.319999999999999,inodoro
1600677429,1600677789,360,0.72,4.319999999999999,inodoro
1600679915,1600680080,165,1.6755555555555557,3.619,lavamanos
1600680008,1600684071,4063,4.722641509433962,13.445,ducha
1600681347,1600681670,323,1.446,0.307,lavamanos
1600684095,1600684128,33,1.9628571428571429,0.382,lavamanos
1600690263,1600695588,5325,2.225892857142857,44.845,lavaplatos
1600691883,1600691921,38,2.6914285714285717,0.725,lavamanos
1600692364,1600692724,360,0.72,4.319999999999999,inodoro
1600701074,1600701111,37,1.005,0.194,lavamanos
1600702210,1600702249,39,0.9323076923076924,0.272,lavamanos
1600702577,1600708100,5523,3.10719512195122,14.642,lavaplatos
1600704391,1600704751,360,0.72,4.319999999999999,inodoro
1600704401,1600704449,48,2.343157894736842,0.879,lavamanos
1600708919,1600710917,1998,6.009980657640232,57.963,ducha
1600708976,1600709487,511,0.42,0.821,lavamanos
1600710193,1600710228,35,3.110909090909091,1.823,lavamanos
1600710843,1600710917,74,0.8775,0.253,lavamanos
1600711115,1600711239,124,1.5719999999999998,0.718,lavaplatos
1600727860,1600728291,431,2.502127659574468,8.455,lavamanos
1600728001,1600728361,360,0.72,4.319999999999999,inodoro
1600757992,1600758352,360,0.72,4.319999999999999,inodoro
1600758094,1600759167,1073,1.893,4.759,lavaplatos
1600761801,1600762161,360,0.72,4.319999999999999,inodoro
1600762920,1600763280,360,0.72,4.319999999999999,inodoro
1600764860,1600765220,360,0.72,4.319999999999999,inodoro
1600769000,1600774093,5093,2.297938144329897,57.328,lavaplatos
1600770033,1600770072,39,1.716,0.513,lavamanos
1600772683,1600772723,40,1.509,0.599,lavamanos
1600772772,1600773132,360,0.72,4.319999999999999,inodoro
1600774202,1600774562,360,0.72,4.319999999999999,inodoro
1600780583,1600780943,360,0.72,4.319999999999999,inodoro
1600781461,1600781470,9,1.2933333333333334,0.196,lavamanos
1600783915,1600784562,647,5.323272120200334,57.249,ducha
1600783939,1600786872,2933,1.0926315789473684,1.052,lavaplatos
1600784079,1600785322,1243,2.204810126582278,3.391,lavamanos
1600785870,1600786230,360,0.72,4.319999999999999,inodoro
1600793149,1600793161,12,0.7963636363636364,0.163,lavamanos
1600795541,1600795901,360,0.72,4.319999999999999,inodoro
1600795647,1600804060,8413,2.774628975265017,31.963,lavaplatos
1600802306,1600802549,243,2.761764705882353,1.743,lavamanos
1600806196,1600806228,32,1.0699999999999998,0.254,lavamanos
1600807836,1600808196,360,0.72,4.319999999999999,inodoro
1600808043,1600808133,90,3.325454545454545,4.463,lavaplatos
1600810012,1600816075,6063,3.417457627118644,7.136,lavaplatos
1600815137,1600815497,360,0.72,4.319999999999999,inodoro
1600815649,1600815812,163,1.0395348837209302,2.344,lavamanos
1600838841,1600839003,162,1.8931428571428568,4.031,lavamanos
1600839273,1600839633,360,0.72,4.319999999999999,inodoro
1600840199,1600840212,13,1.4442857142857144,0.337,lavamanos
1600846529,1600846555,26,3.33,0.375,lavamanos
1600855833,1600855888,55,2.42,1.886,lavamanos
1600855896,1600856715,819,5.535,5.144,lavaplatos
1600874264,1600874498,234,1.8741176470588237,1.129,lavaplatos
1600874444,1600874963,519,2.873846153846154,2.338,lavamanos
1600874455,1600874815,360,0.72,4.319999999999999,inodoro
1600891600,1600891616,16,1.815,0.515,lavamanos
1600897720,1600898080,360,0.72,4.319999999999999,inodoro
1600897735,1600897781,46,1.2525,0.423,lavamanos
1600926370,1600927382,1012,1.7326315789473683,8.052,lavaplatos
1600927726,1600928086,360,0.72,4.319999999999999,inodoro
1600927876,1600927965,89,2.071304347826086,2.56,lavamanos
1600927976,1600928921,945,4.96247191011236,25.069,ducha
1600928983,1600929481,498,1.3199999999999998,0.456,lavamanos
1600930127,1600930487,360,0.72,4.319999999999999,inodoro
1600935161,1600936691,1530,6.058909090909091,6.322,lavaplatos
1600938580,1600938725,145,2.2915068493150685,3.604,lavamanos
1600951329,1600951868,539,1.5885106382978722,7.942,lavaplatos
1600952889,1600952914,25,0.708,0.101,lavamanos
1600956771,1600956830,59,0.41,0.149,lavaplatos
1600957571,1600957941,370,5.564909090909091,34.206,ducha
1600957584,1600957628,44,4.14,0.966,lavamanos
1600958552,1600958594,42,3.594,2.591,lavamanos
1600980062,1600980102,40,0.7971428571428572,0.354,lavamanos
1600980160,1600980520,360,0.72,4.319999999999999,inodoro
1601016607,1601016619,12,0.68,0.149,lavamanos
1601016915,1601017398,483,2.783333333333333,0.893,lavaplatos
1601017538,1601017898,360,0.72,4.319999999999999,inodoro
1601020330,1601021925,1595,2.5244444444444443,5.064,lavaplatos
1601023534,1601023894,360,0.72,4.319999999999999,inodoro
1601024982,1601025022,40,0.994736842105263,0.377,lavamanos
1601026853,1601026857,4,1.728,0.144,lavamanos
1601031377,1601035215,3838,1.657372881355932,30.483,lavaplatos
1601032056,1601032745,689,1.8818181818181816,1.459,lavamanos
1601034992,1601035352,360,0.72,4.319999999999999,inodoro
1601040634,1601040653,19,0.7578947368421053,0.253,lavamanos
1601041568,1601041578,10,0.72,0.072,lavaplatos
1601041825,1601041827,2,0.39,0.015,lavamanos
1601047063,1601047389,326,1.1133333333333333,0.855,lavaplatos
1601049043,1601052345,3302,5.012560175054705,41.788,ducha
1601049666,1601049916,250,3.631153846153846,3.501,lavamanos
1601049786,1601050532,746,2.9125,1.273,lavaplatos
1601051618,1601052126,508,1.96848,11.139,lavamanos
1601053870,1601053973,103,1.26,1.939,lavamanos
1601055068,1601055428,360,0.72,4.319999999999999,inodoro
1601055898,1601056289,391,0.495,0.809,lavaplatos
1601055942,1601055959,17,2.212941176470588,0.672,lavamanos
1601074237,1601074258,21,0.912,0.325,lavamanos
1601103634,1601104246,612,1.7033333333333334,0.563,lavaplatos
1601105770,1601106130,360,0.72,4.319999999999999,inodoro
1601105940,1601106135,195,2.299375,4.256,lavamanos
1601110205,1601112638,2433,3.3257142857142856,1.694,lavaplatos
1601110951,1601111311,360,0.72,4.319999999999999,inodoro
1601115401,1601116103,702,3.0085714285714285,24.007,lavaplatos
1601115500,1601115534,34,1.248,0.164,lavamanos
1601116209,1601116228,19,1.2966666666666666,0.436,lavamanos
1601118859,1601124247,5388,2.0714516129032257,19.701,lavaplatos
1601120010,1601120054,44,1.656923076923077,0.493,lavamanos
1601121011,1601121051,40,1.38,0.271,lavamanos
1601124063,1601124113,50,2.630322580645161,1.534,lavamanos
1601126451,1601126478,27,2.589,0.969,lavamanos
1601126570,1601127683,1113,1.5105882352941176,0.57,lavaplatos
1601132890,1601133250,360,0.72,4.319999999999999,inodoro
1601133067,1601133121,54,2.493103448275862,1.347,lavamanos
1601133554,1601134014,460,5.849431279620853,44.308,ducha
1601134003,1601134003,1,0.36,0.006,lavamanos
1601134617,1601134679,62,5.467499999999999,3.26,lavamanos
1601135392,1601135752,360,0.72,4.319999999999999,inodoro
1601137104,1601138618,1514,1.2985714285714285,0.677,lavaplatos
1601148901,1601149261,360,0.72,4.319999999999999,inodoro
1601194669,1601196155,1486,2.2882666666666664,24.337,lavaplatos
1601195202,1601195562,360,0.72,4.319999999999999,inodoro
1601195212,1601195233,21,4.0600000000000005,0.438,lavamanos
1601196523,1601196863,340,2.154705882352941,2.767,lavamanos
1601196673,1601196959,286,5.414296875,25.908,ducha
1601197721,1601198215,494,1.472142857142857,0.75,lavamanos
1601211754,1601211780,26,1.3941176470588237,0.442,lavamanos
1601211946,1601215402,3456,2.2593220338983047,58.714,lavaplatos
1601214906,1601214953,47,2.322,0.481,lavamanos
1601216186,1601216635,449,1.449230769230769,0.45,lavamanos
1601216212,1601216572,360,0.72,4.319999999999999,inodoro
1601221700,1601221980,280,1.6228571428571428,0.832,lavamanos
1601223672,1601224032,360,0.72,4.319999999999999,inodoro
1601224584,1601226229,1645,3.2585714285714285,5.008,lavaplatos
1601224702,1601224765,63,1.5617142857142856,1.043,lavamanos
1601228495,1601228534,39,3.612,1.081,lavaplatos
1601229940,1601229999,59,2.6225454545454547,2.592,lavamanos
1601230667,1601230855,188,4.462105263157894,4.831,lavaplatos
1601230690,1601230748,58,2.964375,1.743,lavamanos
1601231531,1601231718,187,4.748571428571428,14.769,ducha
1601231614,1601231866,252,2.316867469879518,10.399,lavamanos
1601238252,1601238314,62,1.586,1.239,lavamanos
1601244557,1601244917,360,0.72,4.319999999999999,inodoro
1601274005,1601274035,30,1.8035294117647056,0.577,lavaplatos
1601274495,1601274810,315,1.7248484848484849,3.07,lavamanos
1601275140,1601275500,360,0.72,4.319999999999999,inodoro
1601276293,1601276653,360,0.72,4.319999999999999,inodoro
1601277923,1601277935,12,0.715,0.158,lavamanos
1601284668,1601284686,18,1.92,0.128,lavaplatos
1601286134,1601286149,15,2.952,0.744,lavamanos
1601286672,1601286710,38,3.7966666666666655,1.271,lavaplatos
1601290743,1601294088,3345,3.701739130434783,53.528,lavaplatos
1601293955,1601294333,378,0.931304347826087,2.223,lavamanos
1601295202,1601295562,360,0.72,4.319999999999999,inodoro
1601301443,1601301487,44,2.1507692307692308,0.595,lavamanos
1601303420,1601303439,19,1.893333333333333,0.608,lavamanos
1601303506,1601303866,360,0.72,4.319999999999999,inodoro
1601306413,1601306773,360,0.72,4.319999999999999,inodoro
1601306564,1601306593,29,2.548,0.716,lavaplatos
1601315514,1601320340,4826,2.8692086330935247,19.912,lavaplatos
1601316868,1601316870,2,0.39,0.015,lavamanos
1601317749,1601318109,360,0.72,4.319999999999999,inodoro
1601323139,1601323142,3,1.485,0.099,lavaplatos
1601326421,1601326696,275,2.1591044776119404,6.673,lavaplatos
1601329769,1601329802,33,2.841818181818182,1.125,lavaplatos
1601360325,1601360488,163,0.8624999999999999,0.427,lavamanos
1601360672,1601360708,36,1.9234285714285717,1.188,lavaplatos
1601362850,1601362943,93,1.115,0.544,lavamanos
1601366802,1601366840,38,1.64,0.306,lavamanos
1601374218,1601374229,11,0.4499999999999999,0.046,lavamanos
1601375576,1601376130,554,5.117514450867052,32.25,ducha
1601376230,1601376332,102,3.0908108108108108,4.263,lavamanos
1601377309,1601377669,360,0.72,4.319999999999999,inodoro
1601413720,1601414620,900,0.7092857142857143,0.532,lavamanos
1601413785,1601414620,835,0.12,1.672,ducha
1601415075,1601415435,360,0.72,4.319999999999999,inodoro
1601416045,1601416080,35,0.71,0.256,lavamanos
1601446922,1601446972,50,0.8657142857142857,0.423,lavamanos
1601447946,1601450780,2834,3.0874809160305343,14.965,lavaplatos
1601448662,1601449820,1158,5.489158878504672,55.304,ducha
1601448703,1601448778,75,3.671351351351351,2.479,lavamanos
1601448801,1601449161,360,0.72,4.319999999999999,inodoro
1601449872,1601449905,33,0.99,0.215,lavamanos
1601451054,1601451082,28,1.14,0.272,lavamanos
1601452100,1601452460,360,0.72,4.319999999999999,inodoro
1601456944,1601458097,1153,3.3430188679245285,3.464,lavamanos
1601457928,1601458288,360,0.72,4.319999999999999,inodoro
1601460646,1601460651,5,0.5499999999999999,0.055,lavamanos
1601467104,1601467124,20,1.158,0.215,lavamanos
1601472238,1601472272,34,2.8866666666666667,0.596,lavamanos
1601473945,1601473962,17,0.6952941176470587,0.208,lavamanos
1601474618,1601474626,8,1.7333333333333334,0.26,lavaplatos
1601479001,1601479383,382,2.273333333333333,1.785,lavaplatos
1601479465,1601479963,498,5.76843956043956,48.064,ducha
1601479871,1601479954,83,0.12,0.168,lavamanos
1601480715,1601480786,71,2.705294117647058,1.717,lavamanos
1601497504,1601497541,37,1.3411764705882352,0.469,lavamanos
1601497923,1601498283,360,0.72,4.319999999999999,inodoro
1601511456,1601512075,619,2.302325581395349,3.191,lavamanos
1601511893,1601512253,360,0.72,4.319999999999999,inodoro
1601513505,1601513557,52,1.26,0.144,lavamanos
1601533767,1601534127,360,0.72,4.319999999999999,inodoro
1601535472,1601535479,7,2.9475,0.393,lavaplatos
1601540856,1601541216,360,0.72,4.319999999999999,inodoro
1601541344,1601541704,360,0.72,4.319999999999999,inodoro
1601552139,1601552783,644,3.858333333333333,50.757,lavaplatos
1601552623,1601552651,28,1.83375,0.524,lavamanos
1601553545,1601553943,398,1.8107462686567164,2.246,lavamanos
1601554307,1601554667,360,0.72,4.319999999999999,inodoro
1601554790,1601556280,1490,3.1287197231833908,39.819,lavaplatos
1601556455,1601556500,45,1.56,0.577,lavamanos
1601558730,1601560243,1513,3.04,0.152,lavaplatos
1601563009,1601563056,47,3.871304347826087,1.608,lavaplatos
1601563978,1601564356,378,2.9353125,3.583,lavamanos
1601569150,1601569165,15,2.2885714285714287,0.458,lavaplatos
1601574489,1601574849,360,0.72,4.319999999999999,inodoro
1601574934,1601575697,763,2.355652173913043,2.877,lavaplatos
1601575742,1601575764,22,0.6466666666666667,0.251,lavamanos
1601577541,1601577547,6,0.8099999999999999,0.117,lavamanos
1601591512,1601591595,83,5.566153846153847,3.91,lavaplatos
1601601182,1601601202,20,0.28,0.106,lavamanos
1601618612,1601618693,81,1.598181818181818,0.48,lavaplatos
1601618823,1601618906,83,1.919230769230769,2.661,lavamanos
1601618977,1601619181,204,4.936421052631578,16.753,ducha
1601619922,1601620449,527,0.7566666666666666,2.66,lavamanos
1601621289,1601621649,360,0.72,4.319999999999999,inodoro
1601632883,1601632918,35,2.36,0.408,lavamanos
1601636676,1601636680,4,0.216,0.018,lavamanos
1601645863,1601645893,30,2.543076923076923,0.639,lavamanos
1601655166,1601655405,239,1.817142857142857,0.721,lavaplatos
1601659201,1601659292,91,1.8304225352112675,2.348,lavaplatos
1601663690,1601663721,31,0.96,0.374,lavamanos
1601664497,1601667885,3388,3.023076923076923,40.152,lavaplatos
1601665521,1601665881,360,0.72,4.319999999999999,inodoro
1601670772,1601671266,494,5.39595652173913,44.398,ducha
1601671125,1601671517,392,2.181724137931034,2.319,lavamanos
1601706670,1601706677,7,2.325,0.31,lavaplatos
1601707150,1601707510,360,0.72,4.319999999999999,inodoro
1601707242,1601707544,302,1.843888888888889,6.947,lavamanos
1601713874,1601713897,23,2.0733333333333333,0.341,lavamanos
1601715274,1601715376,102,6.797441860465116,10.348,lavaplatos
1601720612,1601720655,43,1.7976,0.849,lavamanos
1601723345,1601723356,11,0.2599999999999999,0.031,lavamanos
1601730946,1601730960,14,5.473333333333334,0.833,lavamanos
1601738073,1601738518,445,5.06135593220339,37.646,ducha
1601738583,1601738625,42,1.6566666666666665,0.578,lavamanos
1601739021,1601739381,360,0.72,4.319999999999999,inodoro
1601739338,1601740789,1451,2.300952380952381,5.791,lavaplatos
1601739380,1601739431,51,0.8271428571428572,0.447,lavamanos
1601746374,1601746403,29,2.376,0.488,lavaplatos
1601757058,1601757418,360,0.72,4.319999999999999,inodoro
1601766175,1601766535,360,0.72,4.319999999999999,inodoro
1601795198,1601797174,1976,3.6,38.397,lavaplatos
1601795902,1601795917,15,0.584,0.157,lavamanos
1601796050,1601796410,360,0.72,4.319999999999999,inodoro
1601796890,1601797160,270,0.3,0.01,lavamanos
1601800151,1601801228,1077,4.5888679245283015,8.658,lavaplatos
1601801293,1601801309,16,1.5975,0.428,lavamanos
1601803554,1601803593,39,0.888,0.235,lavamanos
1601804169,1601806564,2395,0.7899999999999999,1.771,lavaplatos
1601804768,1601805128,360,0.72,4.319999999999999,inodoro
1601805068,1601805129,61,1.7494736842105263,1.238,lavamanos
1601805110,1601806596,1486,5.939614890885751,118.839,ducha
1601805984,1601806353,369,1.2385714285714284,0.333,lavamanos
1601807015,1601807078,63,2.5302439024390244,1.909,lavamanos
1601807409,1601807769,360,0.72,4.319999999999999,inodoro
1601837735,1601837748,13,0.8630769230769231,0.202,lavamanos
1601837791,1601840598,2807,2.2478571428571428,7.553,lavaplatos
1601838453,1601838462,9,1.08,0.18,lavamanos
1601838527,1601838887,360,0.72,4.319999999999999,inodoro
1601845808,1601845850,42,0.5666666666666667,0.391,lavamanos
1601881639,1601881665,26,1.365,0.22,lavamanos
1601881774,1601882134,360,0.72,4.319999999999999,inodoro
1601882200,1601882231,31,3.1548387096774198,1.684,lavaplatos
1601882711,1601883071,360,0.72,4.319999999999999,inodoro
1601882746,1601882823,77,2.088620689655172,2.199,lavamanos
1601884551,1601884756,205,0.62,0.864,lavaplatos
1601884952,1601885419,467,1.734915254237288,8.422,lavamanos
1601887551,1601890095,2544,1.816,4.81,lavaplatos
1601890266,1601890286,20,1.0073684210526317,0.341,lavamanos
1601894253,1601898174,3921,2.851627906976744,13.793,lavaplatos
1601897286,1601897646,360,0.72,4.319999999999999,inodoro
1601897295,1601897333,38,2.295,0.435,lavamanos
1601902959,1601904876,1917,4.965961538461538,87.606,ducha
1601903578,1601903633,55,1.8176470588235287,1.677,lavamanos
1601904485,1601904502,17,0.8785714285714286,0.274,lavamanos
1601904826,1601905186,360,0.72,4.319999999999999,inodoro
1601906127,1601906190,63,4.192258064516129,2.456,lavamanos
1601914446,1601914499,53,1.6975,0.99,lavamanos
1601914584,1601914593,9,0.42,0.06,lavaplatos
1601916185,1601916545,360,0.72,4.319999999999999,inodoro
1601927744,1601927788,44,1.9926315789473683,0.807,lavamanos
1601928990,1601929350,360,0.72,4.319999999999999,inodoro
1601929171,1601929173,2,1.6,0.08,lavaplatos
1601933824,1601933969,145,1.47,5.521,ducha
1601943056,1601943062,6,0.12,0.014,lavaplatos
1601963513,1601964647,1134,2.846865671641791,13.111,lavaplatos
1601963853,1601964213,360,0.72,4.319999999999999,inodoro
1601965228,1601965302,74,2.657142857142857,3.333,lavamanos
1601965307,1601965729,422,5.157857142857142,36.345,ducha
1601966184,1601966220,36,0.9866666666666666,0.226,lavamanos
1601967072,1601967432,360,0.72,4.319999999999999,inodoro
1601969158,1601969163,5,2.91,0.2,lavamanos
1601971481,1601971599,118,2.3277272727272726,2.034,lavamanos
1601979068,1601979097,29,7.720714285714284,3.751,lavaplatos
1601984893,1601986934,2041,2.8726530612244896,34.87,lavaplatos
1601992129,1601992157,28,0.54,0.093,lavamanos
1601993729,1601993852,123,1.7734615384615384,3.284,lavaplatos
1601994947,1601994996,49,1.0472727272727271,0.664,lavamanos
1602013049,1602013068,19,0.7466666666666667,0.25,lavamanos
1602013168,1602013528,360,0.72,4.319999999999999,inodoro
1602013790,1602014497,707,2.038736842105263,10.658,lavaplatos
1602020303,1602020347,44,0.12,0.09,lavamanos
1602020396,1602020440,44,2.6175,0.423,lavaplatos
1602051687,1602052286,599,2.158333333333333,1.546,lavaplatos
1602052294,1602052654,360,0.72,4.319999999999999,inodoro
1602052527,1602052643,116,1.8296296296296293,2.691,lavamanos
1602052640,1602053020,380,5.534511627906976,21.713,ducha
1602053945,1602054305,360,0.72,4.319999999999999,inodoro
1602054820,1602055180,360,0.72,4.319999999999999,inodoro
1602065441,1602065657,216,0.12,0.434,lavaplatos
1602067610,1602067611,1,0.36,0.012,lavamanos
1602071486,1602073551,2065,2.266060606060606,5.478,lavaplatos
1602072301,1602072353,52,1.815,0.332,lavamanos
1602074333,1602074335,2,0.3799999999999999,0.019,lavamanos
1602084654,1602084672,18,0.97,0.123,lavaplatos
1602084937,1602085297,360,0.72,4.319999999999999,inodoro
1602085091,1602085459,368,6.433565217391304,39.521,ducha
1602085829,1602085889,60,3.5576470588235294,2.255,lavamanos
1602094760,1602094772,12,0.785,0.17,lavamanos
1602095043,1602095080,37,1.98,1.251,lavaplatos
1602095950,1602096004,54,1.68,0.65,lavamanos
1602096774,1602097661,887,1.87,3.597,lavamanos
1602103602,1602103667,65,0.12,0.132,lavaplatos
1602106086,1602106090,4,1.6,0.142,lavamanos
1602107061,1602107067,6,2.2285714285714286,0.26,lavaplatos
1602107725,1602107756,31,4.174285714285714,2.104,lavamanos
1602107817,1602108177,360,0.72,4.319999999999999,inodoro
1602120568,1602120572,4,0.12,0.01,lavaplatos
1602140224,1602140584,360,0.72,4.319999999999999,inodoro
1602140611,1602140971,360,0.72,4.319999999999999,inodoro
1602140753,1602144002,3249,2.89625,39.444,lavaplatos
1602142818,1602143091,273,1.7242105263157894,1.226,lavamanos
1602144094,1602144318,224,2.78,10.208,lavamanos
1602147017,1602147529,512,1.7819512195121952,4.164,lavamanos
1602147542,1602147824,282,5.170867924528301,24.447,ducha
1602148320,1602148327,7,0.735,0.098,lavamanos
1602149874,1602150234,360,0.72,4.319999999999999,inodoro
1602159091,1602159118,27,1.635,0.491,lavamanos
1602159245,1602162154,2909,2.6022857142857143,37.476,lavaplatos
1602163070,1602163070,1,3.36,0.056,lavamanos
1602166401,1602166442,41,1.635,0.519,lavamanos
1602168577,1602168628,51,0.5057142857142857,0.165,lavaplatos
1602169072,1602169098,26,0.75,0.193,lavamanos
1602177096,1602177112,16,0.7949999999999999,0.124,lavamanos
1602177157,1602177517,360,0.72,4.319999999999999,inodoro
1602179193,1602179553,360,0.72,4.319999999999999,inodoro
1602181146,1602182210,1064,2.305862068965517,6.035,lavaplatos
1602182342,1602182380,38,1.62,0.559,lavamanos
1602194306,1602194666,360,0.72,4.319999999999999,inodoro
1602194350,1602194477,127,2.9986363636363635,2.57,lavamanos
1602195449,1602195733,284,1.9816216216216211,5.15,lavaplatos
1602208170,1602208177,7,0.18,0.018,lavaplatos
1602222598,1602224092,1494,1.592,7.607,lavaplatos
1602223289,1602223370,81,0.9241558441558442,1.267,lavamanos
1602223513,1602223698,185,3.92393063583815,12.077,ducha
1602223746,1602224106,360,0.72,4.319999999999999,inodoro
1602224653,1602225103,450,0.6811764705882353,1.097,lavamanos
1602226509,1602226509,1,0.8999999999999999,0.015,lavaplatos
1602228072,1602228432,360,0.72,4.319999999999999,inodoro
1602229664,1602229940,276,5.493461538461538,25.438,ducha
1602231126,1602231168,42,1.9275,0.64,lavamanos
1602265467,1602265498,31,1.0571428571428572,0.41,lavamanos
1602265641,1602266001,360,0.72,4.319999999999999,inodoro
1602266037,1602266049,12,2.6914285714285717,0.398,lavaplatos
1602283770,1602283811,41,1.758,0.4,lavamanos
1602283819,1602283826,7,3.795,0.506,lavaplatos
1602298995,1602299131,136,0.12,0.274,lavaplatos
1602310766,1602311126,360,0.72,4.319999999999999,inodoro
1602310829,1602310837,8,0.6525,0.1,lavamanos
1602311722,1602312068,346,2.493294797687861,9.421,lavaplatos
1602312181,1602312541,360,0.72,4.319999999999999,inodoro
1602312267,1602312299,32,0.8883870967741935,0.49,lavamanos
1602317621,1602317710,89,4.463333333333333,4.054,lavaplatos
1602320252,1602320846,594,2.975675675675676,6.014,lavamanos
1602320395,1602320755,360,0.72,4.319999999999999,inodoro
1602321010,1602325865,4855,3.043265306122449,41.473,lavaplatos
1602325020,1602325075,55,3.9,1.131,lavamanos
1602326310,1602326324,14,0.885,0.081,lavamanos
1602328184,1602329033,849,4.862281368821293,34.516,ducha
1602328378,1602328889,511,2.6990476190476187,6.378,lavamanos
1602329344,1602329704,360,0.72,4.319999999999999,inodoro
1602338441,1602338542,101,2.358,3.379,lavamanos
1602339348,1602339776,428,2.5578947368421048,8.238,lavaplatos
1602340587,1602341303,716,2.687142857142857,2.066,lavamanos
1602343271,1602343281,10,0.4499999999999999,0.033,lavaplatos
1602346100,1602346460,360,0.72,4.319999999999999,inodoro
1602358955,1602358996,41,0.12,0.084,lavaplatos
1602366729,1602366745,16,1.575,0.449,lavamanos
1602366920,1602367280,360,0.72,4.319999999999999,inodoro
1602369464,1602369529,65,2.1,0.636,lavamanos
1602400120,1602400124,4,0.6719999999999999,0.056,lavamanos
1602400160,1602400904,744,1.8315,2.951,lavaplatos
1602401411,1602401771,360,0.72,4.319999999999999,inodoro
1602401469,1602401469,1,0.36,0.006,lavamanos
1602413081,1602413441,360,0.72,4.319999999999999,inodoro
1602413259,1602415648,2389,2.256091954022988,34.75,lavaplatos
1602416186,1602416546,360,0.72,4.319999999999999,inodoro
1602422180,1602422202,22,0.7919999999999999,0.102,lavamanos
1602429778,1602429792,14,2.052857142857143,0.524,lavaplatos
1602430539,1602431233,694,2.1185106382978725,7.059,lavamanos
1602430991,1602431499,508,7.155761589403974,60.678,ducha
1602432195,1602432266,71,4.433142857142857,4.361,lavamanos
1602453763,1602453823,60,1.917857142857143,1.102,lavamanos
1602454287,1602454314,27,1.105,0.275,lavaplatos
1602454984,1602455183,199,0.2314285714285714,0.079,lavamanos
1602455186,1602455546,360,0.72,4.319999999999999,inodoro
1602481162,1602481213,51,2.536666666666666,0.881,lavaplatos
1602481467,1602481827,360,0.72,4.319999999999999,inodoro
1602481541,1602482196,655,2.3260975609756094,3.549,lavamanos
1602481638,1602481823,185,5.669479768786126,17.447,ducha
1602482083,1602482443,360,0.72,4.319999999999999,inodoro
1602483015,1602483375,360,0.72,4.319999999999999,inodoro
1602483159,1602483189,30,0.6733333333333332,0.211,lavamanos
1602485863,1602485891,28,1.457142857142857,0.414,lavamanos
1602486390,1602486393,3,2.06,0.105,lavaplatos
1602504577,1602504589,12,0.12,0.026,lavaplatos
1602527074,1602527112,38,3.337894736842105,1.162,lavamanos
1602527195,1602527326,131,1.7388461538461537,3.408,lavaplatos
1602528379,1602528739,360,0.72,4.319999999999999,inodoro
1602528819,1602529680,861,0.12,1.724,ducha
1602529680,1602529684,4,0.51,0.056,lavamanos
1602530989,1602530989,1,7.92,0.132,lavaplatos
1602538597,1602538797,200,0.82375,1.014,lavamanos
1602546073,1602547723,1650,0.12,0.79,lavaplatos
1602568504,1602568864,360,0.72,4.319999999999999,inodoro
1602568624,1602569205,581,2.4623376623376623,14.527,lavaplatos
1602569549,1602569762,213,2.6985185185185183,7.583,lavamanos
1602569550,1602569957,407,5.3146875,13.672,ducha
1602570934,1602571451,517,1.842127659574468,1.574,lavamanos
1602574608,1602574968,360,0.72,4.319999999999999,inodoro
1602579158,1602579190,32,1.8825,0.301,lavamanos
1602579600,1602579601,1,3.42,0.114,lavaplatos
1602608791,1602612952,4161,2.189684210526316,21.9,lavaplatos
1602609797,1602610064,267,1.7014285714285713,0.608,lavamanos
1602610937,1602611297,360,0.72,4.319999999999999,inodoro
1602610988,1602611058,70,2.481176470588235,1.727,lavamanos
1602612790,1602613449,659,3.3325925925925923,7.523,lavamanos
1602612895,1602613255,360,0.72,4.319999999999999,inodoro
1602614260,1602614266,6,1.4,0.169,lavamanos
1602618764,1602618810,46,3.2357142857142858,0.888,lavamanos
1602622997,1602623357,360,0.72,4.319999999999999,inodoro
1602623017,1602623630,613,3.4395918367346936,2.983,lavamanos
1602623600,1602623960,360,0.72,4.319999999999999,inodoro
1602625092,1602626159,1067,2.198490566037736,2.163,lavaplatos
1602625855,1602627376,1521,0.2,0.15,ducha
1602627305,1602627405,100,1.77375,0.795,lavamanos
1602628864,1602628864,1,1.08,0.018,lavaplatos
1602630166,1602630206,40,1.235,0.339,lavamanos
1602649469,1602649474,5,0.12,0.012,lavaplatos
1602657202,1602657562,360,0.72,4.319999999999999,inodoro
1602658146,1602658212,66,3.278709677419355,3.618,lavamanos
1602658261,1602660501,2240,4.895438596491228,16.647,ducha
1602658850,1602658889,39,1.097142857142857,0.194,lavamanos
1602663830,1602664190,360,0.72,4.319999999999999,inodoro
1602666102,1602666137,35,0.9342857142857144,0.167,lavamanos
1602668967,1602669132,165,1.9430769230769231,2.183,lavamanos
1602677955,1602677962,7,0.2228571428571428,0.028,lavamanos
1602684305,1602685309,1004,0.18,3.026,ducha
1602684812,1602685309,497,0.1599999999999999,0.008,lavamanos
1602689805,1602689821,16,0.12,0.034,lavaplatos
1602693951,1602694199,248,5.668706896551724,23.389,ducha
1602695196,1602695264,68,3.857560975609756,2.891,lavamanos
1602707873,1602710547,2674,0.12,0.388,ducha
1602707887,1602708189,302,2.096363636363636,1.42,lavamanos
1602708142,1602708502,360,0.72,4.319999999999999,inodoro
1602709214,1602709574,360,0.72,4.319999999999999,inodoro
1602710452,1602710812,360,0.72,4.319999999999999,inodoro
1602710589,1602710623,34,0.9428571428571428,0.166,lavamanos
1602713262,1602713622,360,0.72,4.319999999999999,inodoro
1602736791,1602737151,360,0.72,4.319999999999999,inodoro
1602736808,1602736855,47,1.417894736842105,0.516,lavamanos
1602746916,1602746954,38,1.0235294117647058,0.352,lavamanos
1602747255,1602747615,360,0.72,4.319999999999999,inodoro
1602748152,1602749257,1105,5.079714285714286,60.651,ducha
1602748287,1602748460,173,3.514576271186441,4.871,lavaplatos
1602748699,1602749059,360,0.72,4.319999999999999,inodoro
1602748833,1602749001,168,1.859411764705882,3.797,lavamanos
1602751389,1602751412,23,1.464,0.207,lavamanos
1602753151,1602753192,41,1.7639999999999998,0.221,lavamanos
1602756067,1602756082,15,0.408,0.056,lavamanos
1602761499,1602761595,96,2.516363636363636,1.6,lavamanos
1602770085,1602770094,9,1.7299999999999998,0.239,lavaplatos
1602771695,1602772306,611,6.378115183246073,65.096,ducha
1602772264,1602772675,411,3.18,2.157,lavamanos
1602787275,1602787678,403,1.3418181818181818,1.179,lavamanos
1602787485,1602787845,360,0.72,4.319999999999999,inodoro
1602787678,1602790576,2898,2.6703448275862067,4.651,lavaplatos
1602790748,1602791108,360,0.72,4.319999999999999,inodoro
1602790798,1602790838,40,2.295,0.705,lavamanos
1602793109,1602793469,360,0.72,4.319999999999999,inodoro
1602794268,1602794293,25,0.696,0.301,lavamanos
1602796122,1602798029,1907,2.889627507163324,24.758,lavaplatos
1602796904,1602797782,878,0.345,5.021,ducha
1602797347,1602797394,47,2.4466666666666668,0.834,lavamanos
1602798783,1602798858,75,3.564324324324324,2.406,lavamanos
1602820724,1602821809,1085,0.84,0.438,lavaplatos
1602821547,1602821743,196,5.076,16.645,ducha
1602821558,1602821660,102,3.0759183673469384,2.78,lavamanos
1602822174,1602822534,360,0.72,4.319999999999999,inodoro
1602822264,1602822402,138,3.557045454545454,5.846,lavamanos
1602837777,1602837861,84,0.12,0.17,lavaplatos
1602974691,1602975642,951,3.4516216216216216,4.615,lavaplatos
1602976476,1602976483,7,0.18,0.018,lavamanos
1603001947,1603001951,4,0.444,0.037,lavamanos
1603005443,1603005473,30,0.6074999999999999,0.153,lavamanos
1603006741,1603007101,360,0.72,4.319999999999999,inodoro
1603007521,1603007616,95,4.44,4.262,lavamanos
1603016823,1603017794,971,3.1026315789473684,2.212,lavaplatos
1603018060,1603018420,360,0.72,4.319999999999999,inodoro
1603045391,1603045399,8,0.12,0.018,lavaplatos
1603230693,1603230714,21,1.668,0.338,lavamanos
1603236085,1603236085,1,22.92,0.382,ducha
1603236085,1603236085,1,16.86,0.281,lavamanos
1603264258,1603264277,19,7.481249999999999,2.154,lavaplatos
1603264814,1603265174,360,0.72,4.319999999999999,inodoro
1603268634,1603269019,385,0.74,0.801,lavamanos
1603273922,1603274015,93,3.0347368421052634,1.339,lavamanos
1603281592,1603281609,17,0.7949999999999999,0.24,lavamanos
1603284054,1603286738,2684,2.618630136986301,25.592,lavaplatos
1603287281,1603287315,34,1.9114285714285717,0.322,lavamanos
1603295453,1603296777,1324,2.203636363636364,0.527,lavaplatos
1603295867,1603295915,48,2.271428571428572,0.43,lavamanos
1603295999,1603296626,627,5.130358974358974,53.672,ducha
1603296754,1603296831,77,2.709677419354839,3.077,lavamanos
1603297236,1603297596,360,0.72,4.319999999999999,inodoro
1603805540,1603805572,32,0.885,0.117,lavamanos
1603805590,1603813891,8301,5.70072463768116,66.184,ducha
1603805620,1603805622,2,2.0,0.1,lavaplatos
1603809917,1603811360,1443,2.1516190476190475,31.51,lavaplatos
1603810974,1603810974,1,0.54,0.009,lavamanos
1603811765,1603812638,873,1.74,3.418,lavamanos
1603813404,1603814074,670,3.3123529411764703,2.116,lavamanos
1603904458,1603905130,672,5.014285714285714,46.44,lavaplatos
1603905072,1603905159,87,3.433333333333333,1.975,lavamanos
1604070994,1604071411,417,5.8,21.227,lavaplatos
1604071047,1604071209,162,0.51,0.661,ducha
1604226943,1604228386,1443,4.666,16.7,lavaplatos
1604423258,1604424081,823,3.889696969696969,7.446,lavaplatos
1604423416,1604423438,22,4.09,0.443,lavamanos
